"Pctcd","Ducey, Doug","Sinema, Kyrsten","total","County","DistCD","DistLD","color"
"AP0002",231,81,312,"APACHE",1,7,"#aa2222"
"AP0003",253,1292,1545,"APACHE",1,7,"#000066"
"AP0005",121,601,722,"APACHE",1,7,"#000066"
"AP0009",1103,298,1401,"APACHE",1,7,"#881111"
"AP0010",67,314,381,"APACHE",1,7,"#000066"
"AP0011",133,559,692,"APACHE",1,7,"#000066"
"AP0012",555,85,640,"APACHE",1,7,"#660000"
"AP0013",105,390,495,"APACHE",1,7,"#111188"
"AP0016",725,142,867,"APACHE",1,7,"#660000"
"AP0017",533,108,641,"APACHE",1,7,"#660000"
"AP0019",377,1251,1628,"APACHE",1,7,"#111188"
"AP0022",59,293,352,"APACHE",1,7,"#000066"
"AP0023",89,430,519,"APACHE",1,7,"#000066"
"AP0025",94,41,135,"APACHE",1,7,"#cc3333"
"AP0027",154,408,562,"APACHE",1,7,"#2222aa"
"AP0029",77,482,559,"APACHE",1,7,"#000066"
"AP0031",87,346,433,"APACHE",1,7,"#111188"
"AP0033",89,668,757,"APACHE",1,7,"#000066"
"AP0035",65,244,309,"APACHE",1,7,"#111188"
"AP0037",19,58,77,"APACHE",1,7,"#111188"
"AP0039",76,620,696,"APACHE",1,7,"#000066"
"AP0041",9,57,66,"APACHE",1,7,"#000066"
"AP0043",74,398,472,"APACHE",1,7,"#000066"
"AP0045",205,78,283,"APACHE",1,7,"#aa2222"
"AP0046",52,214,266,"APACHE",1,7,"#000066"
"AP0048",282,481,763,"APACHE",1,7,"#4747eb"
"AP0051",20,75,95,"APACHE",1,7,"#111188"
"AP0052",71,238,309,"APACHE",1,7,"#111188"
"AP0054",85,540,625,"APACHE",1,7,"#000066"
"AP0056",50,322,372,"APACHE",1,7,"#000066"
"AP0058",49,390,439,"APACHE",1,7,"#000066"
"AP0059",437,88,525,"APACHE",1,7,"#660000"
"AP0061",660,213,873,"APACHE",1,7,"#881111"
"AP0065",176,850,1026,"APACHE",1,7,"#000066"
"AP0067",54,336,390,"APACHE",1,7,"#000066"
"AP0070",518,185,703,"APACHE",1,7,"#aa2222"
"AP0074",80,539,619,"APACHE",1,7,"#000066"
"AP0076",49,243,292,"APACHE",1,7,"#000066"
"AP0078",49,207,256,"APACHE",1,7,"#000066"
"AP0080",53,261,314,"APACHE",1,7,"#000066"
"AP0082",866,224,1090,"APACHE",1,7,"#881111"
"AP0084",66,656,722,"APACHE",1,7,"#000066"
"AP0086",74,320,394,"APACHE",1,7,"#000066"
"AP0088",184,672,856,"APACHE",1,7,"#111188"
"CH0001",721,333,1054,"COCHISE",2,14,"#cc3333"
"CH0002",996,363,1359,"COCHISE",2,14,"#aa2222"
"CH0003",807,393,1200,"COCHISE",2,14,"#cc3333"
"CH0004",194,752,946,"COCHISE",2,14,"#111188"
"CH0005",416,498,914,"COCHISE",2,14,"#aaaeff"
"CH0006",368,633,1001,"COCHISE",2,14,"#4747eb"
"CH0007",122,55,177,"COCHISE",2,14,"#cc3333"
"CH0008",881,326,1207,"COCHISE",2,14,"#aa2222"
"CH0009",177,534,711,"COCHISE",2,14,"#111188"
"CH0010",366,710,1076,"COCHISE",2,14,"#3333cc"
"CH0011",145,646,791,"COCHISE",2,14,"#000066"
"CH0012",141,463,604,"COCHISE",2,14,"#111188"
"CH0013",289,446,735,"COCHISE",2,14,"#4747eb"
"CH0014",924,329,1253,"COCHISE",2,14,"#aa2222"
"CH0015",993,416,1409,"COCHISE",2,14,"#aa2222"
"CH0016",382,228,610,"COCHISE",2,14,"#eb4747"
"CH0017",453,184,637,"COCHISE",2,14,"#aa2222"
"CH0018",115,210,325,"COCHISE",2,14,"#4747eb"
"CH0019",614,255,869,"COCHISE",2,14,"#aa2222"
"CH0020",241,385,626,"COCHISE",2,14,"#4747eb"
"CH0021",533,225,758,"COCHISE",2,14,"#aa2222"
"CH0022",135,104,239,"COCHISE",2,14,"#f58181"
"CH0023",125,28,153,"COCHISE",2,14,"#660000"
"CH0024",1055,302,1357,"COCHISE",2,14,"#881111"
"CH0025",231,103,334,"COCHISE",2,14,"#cc3333"
"CH0026",926,494,1420,"COCHISE",2,14,"#cc3333"
"CH0027",1266,650,1916,"COCHISE",2,14,"#cc3333"
"CH0028",581,385,966,"COCHISE",2,14,"#eb4747"
"CH0029",436,270,706,"COCHISE",2,14,"#eb4747"
"CH0030",337,212,549,"COCHISE",2,14,"#eb4747"
"CH0031",703,387,1090,"COCHISE",2,14,"#eb4747"
"CH0032",1293,524,1817,"COCHISE",2,14,"#aa2222"
"CH0033",790,382,1172,"COCHISE",2,14,"#cc3333"
"CH0034",601,359,960,"COCHISE",2,14,"#eb4747"
"CH0035",948,324,1272,"COCHISE",2,14,"#aa2222"
"CH0036",565,340,905,"COCHISE",2,14,"#eb4747"
"CH0037",792,298,1090,"COCHISE",2,14,"#aa2222"
"CH0038",466,283,749,"COCHISE",2,14,"#eb4747"
"CH0039",649,514,1163,"COCHISE",2,14,"#f58181"
"CH0040",980,378,1358,"COCHISE",2,14,"#aa2222"
"CH0041",1092,518,1610,"COCHISE",2,14,"#cc3333"
"CH0042",639,356,995,"COCHISE",2,14,"#eb4747"
"CH0043",1248,464,1712,"COCHISE",2,14,"#aa2222"
"CH0044",862,284,1146,"COCHISE",2,14,"#881111"
"CH0045",271,110,381,"COCHISE",2,14,"#aa2222"
"CH0046",1078,355,1433,"COCHISE",2,14,"#881111"
"CH0047",672,238,910,"COCHISE",2,14,"#aa2222"
"CH0048",614,165,779,"COCHISE",2,14,"#881111"
"CH0049",405,172,577,"COCHISE",2,14,"#aa2222"
"CN0001",257,921,1178,"COCONINO",1,6,"#111188"
"CN0002",211,874,1085,"COCONINO",1,6,"#000066"
"CN0003",106,712,818,"COCONINO",1,6,"#000066"
"CN0004",404,974,1378,"COCONINO",1,6,"#2222aa"
"CN0005",604,1152,1756,"COCONINO",1,6,"#3333cc"
"CN0006",437,707,1144,"COCONINO",1,6,"#4747eb"
"CN0007",378,664,1042,"COCONINO",1,6,"#4747eb"
"CN0008",217,519,736,"COCONINO",1,6,"#2222aa"
"CN0009",255,697,952,"COCONINO",1,6,"#2222aa"
"CN0010",51,283,334,"COCONINO",1,6,"#000066"
"CN0011",181,429,610,"COCONINO",1,6,"#2222aa"
"CN0012",113,609,722,"COCONINO",1,6,"#000066"
"CN0013",68,352,420,"COCONINO",1,6,"#000066"
"CN0014",165,662,827,"COCONINO",1,6,"#000066"
"CN0015",512,1236,1748,"COCONINO",1,6,"#2222aa"
"CN0016",497,1001,1498,"COCONINO",1,6,"#3333cc"
"CN0017",173,266,439,"COCONINO",1,6,"#4747eb"
"CN0018",224,314,538,"COCONINO",1,6,"#8181f5"
"CN0019",553,805,1358,"COCONINO",1,6,"#8181f5"
"CN0020",90,410,500,"COCONINO",1,6,"#000066"
"CN0021",672,1114,1786,"COCONINO",1,6,"#4747eb"
"CN0022",889,1268,2157,"COCONINO",1,6,"#8181f5"
"CN0023",349,661,1010,"COCONINO",1,6,"#3333cc"
"CN0024",925,1103,2028,"COCONINO",1,6,"#aaaeff"
"CN0025",546,852,1398,"COCONINO",1,6,"#4747eb"
"CN0026",306,336,642,"COCONINO",1,6,"#d5d9ff"
"CN0040",214,158,372,"COCONINO",1,6,"#f58181"
"CN0041",363,115,478,"COCONINO",1,6,"#881111"
"CN0042",193,460,653,"COCONINO",1,7,"#2222aa"
"CN0043",175,467,642,"COCONINO",1,7,"#2222aa"
"CN0047",86,266,352,"COCONINO",1,7,"#111188"
"CN0048",32,159,191,"COCONINO",1,7,"#000066"
"CN0050",845,621,1466,"COCONINO",1,6,"#f58181"
"CN0051",29,24,53,"COCONINO",1,7,"#ffaaae"
"CN0052",818,589,1407,"COCONINO",1,6,"#f58181"
"CN0053",109,41,150,"COCONINO",1,6,"#aa2222"
"CN0055",125,168,293,"COCONINO",1,7,"#8181f5"
"CN0056",273,296,569,"COCONINO",1,6,"#d5d9ff"
"CN0058",345,82,427,"COCONINO",1,7,"#660000"
"CN0059",146,399,545,"COCONINO",1,6,"#2222aa"
"CN0060",8,33,41,"COCONINO",1,7,"#000066"
"CN0061",128,223,351,"COCONINO",1,7,"#4747eb"
"CN0062",893,1334,2227,"COCONINO",1,6,"#8181f5"
"CN0063",98,54,152,"COCONINO",1,6,"#eb4747"
"CN0064",6,1,7,"COCONINO",1,7,"#660000"
"CN0065",166,530,696,"COCONINO",1,7,"#111188"
"CN0066",298,107,405,"COCONINO",1,6,"#aa2222"
"CN0067",182,362,544,"COCONINO",1,7,"#3333cc"
"CN0069",229,566,795,"COCONINO",1,7,"#2222aa"
"CN0070",57,129,186,"COCONINO",1,7,"#3333cc"
"CN0071",30,61,91,"COCONINO",1,7,"#3333cc"
"CN0072",386,265,651,"COCONINO",1,7,"#f58181"
"CN0073",406,225,631,"COCONINO",1,7,"#eb4747"
"CN0074",219,233,452,"COCONINO",1,7,"#d5d9ff"
"CN0075",505,313,818,"COCONINO",1,7,"#eb4747"
"CN0079",535,241,776,"COCONINO",1,6,"#cc3333"
"CN0080",424,284,708,"COCONINO",1,6,"#f58181"
"CN0082",292,414,706,"COCONINO",1,6,"#8181f5"
"CN0083",564,713,1277,"COCONINO",1,6,"#8181f5"
"CN0084",236,148,384,"COCONINO",1,6,"#eb4747"
"CN0085",752,545,1297,"COCONINO",1,6,"#f58181"
"CN0086",107,71,178,"COCONINO",1,7,"#eb4747"
"CN0088",68,206,274,"COCONINO",1,7,"#111188"
"CN0090",202,854,1056,"COCONINO",1,7,"#000066"
"CN0092",657,590,1247,"COCONINO",1,7,"#ffaaae"
"CN0093",128,454,582,"COCONINO",1,7,"#111188"
"CN0094",89,351,440,"COCONINO",1,7,"#111188"
"CN0095",400,1353,1753,"COCONINO",1,7,"#111188"
"CN0097",247,164,411,"COCONINO",1,6,"#eb4747"
"CN0098",1110,425,1535,"COCONINO",1,6,"#aa2222"
"CN0099",420,225,645,"COCONINO",1,6,"#cc3333"
"GI0100",260,144,404,"GILA",1,8,"#eb4747"
"GI0105",81,79,160,"GILA",1,8,"#ffd5d9"
"GI0110",42,50,92,"GILA",1,8,"#aaaeff"
"GI0115",220,206,426,"GILA",1,8,"#ffd5d9"
"GI0120",351,232,583,"GILA",1,8,"#eb4747"
"GI0125",204,132,336,"GILA",1,8,"#eb4747"
"GI0130",169,196,365,"GILA",1,8,"#aaaeff"
"GI0135",342,165,507,"GILA",1,8,"#cc3333"
"GI0140",342,222,564,"GILA",1,8,"#eb4747"
"GI0150",153,123,276,"GILA",1,8,"#f58181"
"GI0155",136,208,344,"GILA",1,8,"#4747eb"
"GI0160",346,180,526,"GILA",1,8,"#cc3333"
"GI0165",270,191,461,"GILA",1,8,"#f58181"
"GI0170",148,138,286,"GILA",1,8,"#ffd5d9"
"GI0175",161,109,270,"GILA",1,8,"#f58181"
"GI0180",122,80,202,"GILA",1,8,"#eb4747"
"GI0185",65,35,100,"GILA",1,8,"#cc3333"
"GI0200",575,214,789,"GILA",4,6,"#aa2222"
"GI0205",992,348,1340,"GILA",4,6,"#aa2222"
"GI0210",1492,584,2076,"GILA",4,6,"#aa2222"
"GI0215",544,251,795,"GILA",4,6,"#cc3333"
"GI0220",871,342,1213,"GILA",4,6,"#aa2222"
"GI0225",528,226,754,"GILA",4,6,"#aa2222"
"GI0230",422,169,591,"GILA",4,6,"#aa2222"
"GI0235",681,272,953,"GILA",4,6,"#aa2222"
"GI0240",1310,431,1741,"GILA",4,6,"#881111"
"GI0300",142,297,439,"GILA",1,8,"#3333cc"
"GI0305",248,83,331,"GILA",4,6,"#aa2222"
"GI0310",335,128,463,"GILA",4,6,"#aa2222"
"GI0315",937,390,1327,"GILA",4,6,"#aa2222"
"GI0320",119,34,153,"GILA",1,6,"#881111"
"GI0325",75,21,96,"GILA",4,6,"#881111"
"GI0330",715,207,922,"GILA",4,6,"#881111"
"GI0335",140,53,193,"GILA",4,6,"#aa2222"
"GI0340",340,62,402,"GILA",4,6,"#660000"
"GI0345",309,137,446,"GILA",4,6,"#cc3333"
"GI0400",54,212,266,"GILA",1,7,"#111188"
"GI0405",4,14,18,"GILA",1,7,"#111188"
"GI0410",199,678,877,"GILA",1,7,"#111188"
"GM0001",417,227,644,"GRAHAM",1,14,"#eb4747"
"GM0002",542,301,843,"GRAHAM",1,14,"#eb4747"
"GM0003",297,115,412,"GRAHAM",1,14,"#aa2222"
"GM0004",208,140,348,"GRAHAM",1,14,"#f58181"
"GM0005",594,290,884,"GRAHAM",1,14,"#cc3333"
"GM0006",423,86,509,"GRAHAM",1,14,"#660000"
"GM0007",852,245,1097,"GRAHAM",1,14,"#881111"
"GM0008",332,41,373,"GRAHAM",1,14,"#660000"
"GM0009",1182,268,1450,"GRAHAM",1,14,"#660000"
"GM0010",166,28,194,"GRAHAM",1,14,"#660000"
"GM0011",120,509,629,"GRAHAM",1,7,"#000066"
"GM0012",31,14,45,"GRAHAM",1,14,"#cc3333"
"GM0013",106,11,117,"GRAHAM",1,14,"#660000"
"GM0014",164,43,207,"GRAHAM",1,14,"#881111"
"GM0015",614,386,1000,"GRAHAM",1,14,"#eb4747"
"GM0016",57,211,268,"GRAHAM",1,7,"#111188"
"GM0017",106,36,142,"GRAHAM",1,14,"#aa2222"
"GM0018",601,168,769,"GRAHAM",1,14,"#881111"
"GM0019",539,142,681,"GRAHAM",1,14,"#881111"
"GM0020",362,88,450,"GRAHAM",1,14,"#660000"
"GM0021",49,12,61,"GRAHAM",1,14,"#660000"
"GM0022",14,7,21,"GRAHAM",1,14,"#cc3333"
"GN0001",14,0,14,"GREENLEE",1,14,"#660000"
"GN0002",32,4,36,"GREENLEE",1,14,"#660000"
"GN0003",188,274,462,"GREENLEE",1,14,"#8181f5"
"GN0004",193,185,378,"GREENLEE",1,14,"#ffd5d9"
"GN0005",352,195,547,"GREENLEE",1,14,"#eb4747"
"GN0006",92,57,149,"GREENLEE",1,14,"#eb4747"
"GN0007",329,164,493,"GREENLEE",1,14,"#cc3333"
"GN0008",437,163,600,"GREENLEE",1,14,"#aa2222"
"LP0051",869,652,1521,"LA_PAZ",4,5,"#f58181"
"LP0052",68,110,178,"LA_PAZ",4,5,"#4747eb"
"LP0054",896,248,1144,"LA_PAZ",4,5,"#881111"
"LP0055",281,65,346,"LA_PAZ",4,5,"#660000"
"LP0056",75,33,108,"LA_PAZ",4,5,"#cc3333"
"LP0057",505,154,659,"LA_PAZ",4,5,"#881111"
"LP0058",560,180,740,"LA_PAZ",4,5,"#881111"
"LP0059",52,13,65,"LA_PAZ",4,5,"#660000"
"LP0060",168,44,212,"LA_PAZ",4,5,"#881111"
"LP0062",136,32,168,"LA_PAZ",4,5,"#660000"
"LP0064",242,78,320,"LA_PAZ",4,5,"#881111"
"MC0001",1102,1209,2311,"MARICOPA",6,20,"#d5d9ff"
"MC0002",1440,757,2197,"MARICOPA",8,21,"#cc3333"
"MC0003",286,1032,1318,"MARICOPA",7,29,"#111188"
"MC0004",879,590,1469,"MARICOPA",6,15,"#f58181"
"MC0005",2734,1807,4541,"MARICOPA",5,12,"#eb4747"
"MC0006",750,477,1227,"MARICOPA",8,21,"#eb4747"
"MC0007",163,59,222,"MARICOPA",4,13,"#aa2222"
"MC0008",1481,1683,3164,"MARICOPA",9,18,"#aaaeff"
"MC0009",701,738,1439,"MARICOPA",8,29,"#d5d9ff"
"MC0010",924,1290,2214,"MARICOPA",9,17,"#8181f5"
"MC0011",1946,2295,4241,"MARICOPA",9,18,"#aaaeff"
"MC0012",170,367,537,"MARICOPA",7,30,"#3333cc"
"MC0013",1029,601,1630,"MARICOPA",8,22,"#eb4747"
"MC0014",261,160,421,"MARICOPA",8,13,"#eb4747"
"MC0015",706,364,1070,"MARICOPA",8,20,"#cc3333"
"MC0016",346,556,902,"MARICOPA",3,19,"#4747eb"
"MC0017",637,664,1301,"MARICOPA",6,28,"#d5d9ff"
"MC0018",672,648,1320,"MARICOPA",6,20,"#ffd5d9"
"MC0019",762,866,1628,"MARICOPA",6,28,"#aaaeff"
"MC0020",1784,1327,3111,"MARICOPA",8,22,"#f58181"
"MC0021",1254,1063,2317,"MARICOPA",6,15,"#ffaaae"
"MC0022",621,376,997,"MARICOPA",5,16,"#eb4747"
"MC0023",909,595,1504,"MARICOPA",8,21,"#eb4747"
"MC0024",2330,1350,3680,"MARICOPA",5,25,"#eb4747"
"MC0025",2286,1880,4166,"MARICOPA",5,17,"#ffaaae"
"MC0026",1983,847,2830,"MARICOPA",5,25,"#aa2222"
"MC0027",1029,1344,2373,"MARICOPA",9,28,"#8181f5"
"MC0028",676,1664,2340,"MARICOPA",7,27,"#2222aa"
"MC0029",110,27,137,"MARICOPA",3,4,"#660000"
"MC0030",884,633,1517,"MARICOPA",8,22,"#f58181"
"MC0031",1031,923,1954,"MARICOPA",5,12,"#ffaaae"
"MC0032",1078,770,1848,"MARICOPA",6,15,"#f58181"
"MC0033",1032,804,1836,"MARICOPA",8,21,"#f58181"
"MC0034",298,422,720,"MARICOPA",6,30,"#8181f5"
"MC0035",1319,864,2183,"MARICOPA",5,16,"#eb4747"
"MC0036",1711,1373,3084,"MARICOPA",6,15,"#f58181"
"MC0037",242,567,809,"MARICOPA",3,19,"#2222aa"
"MC0038",1651,1174,2825,"MARICOPA",5,16,"#f58181"
"MC0039",848,1575,2423,"MARICOPA",9,26,"#3333cc"
"MC0040",457,1362,1819,"MARICOPA",7,24,"#2222aa"
"MC0041",764,863,1627,"MARICOPA",9,24,"#aaaeff"
"MC0042",2288,1943,4231,"MARICOPA",5,17,"#ffaaae"
"MC0043",2213,1358,3571,"MARICOPA",8,22,"#eb4747"
"MC0044",590,591,1181,"MARICOPA",8,20,"#d5d9ff"
"MC0045",689,741,1430,"MARICOPA",9,28,"#d5d9ff"
"MC0046",143,268,411,"MARICOPA",7,29,"#3333cc"
"MC0047",133,506,639,"MARICOPA",7,27,"#111188"
"MC0048",1115,1048,2163,"MARICOPA",9,28,"#ffd5d9"
"MC0049",1323,609,1932,"MARICOPA",8,1,"#cc3333"
"MC0050",1199,1541,2740,"MARICOPA",6,28,"#8181f5"
"MC0051",1541,839,2380,"MARICOPA",8,22,"#eb4747"
"MC0052",989,888,1877,"MARICOPA",6,15,"#ffaaae"
"MC0053",814,487,1301,"MARICOPA",5,16,"#eb4747"
"MC0054",633,309,942,"MARICOPA",8,22,"#cc3333"
"MC0055",1664,1717,3381,"MARICOPA",6,20,"#d5d9ff"
"MC0056",1172,910,2082,"MARICOPA",6,15,"#f58181"
"MC0057",1120,601,1721,"MARICOPA",8,22,"#cc3333"
"MC0058",115,206,321,"MARICOPA",7,29,"#4747eb"
"MC0059",1330,831,2161,"MARICOPA",8,22,"#eb4747"
"MC0060",1852,1081,2933,"MARICOPA",6,23,"#eb4747"
"MC0061",2711,1521,4232,"MARICOPA",5,12,"#eb4747"
"MC0062",513,376,889,"MARICOPA",3,4,"#f58181"
"MC0063",620,797,1417,"MARICOPA",9,26,"#8181f5"
"MC0064",1371,1255,2626,"MARICOPA",6,20,"#ffd5d9"
"MC0065",69,45,114,"MARICOPA",3,4,"#eb4747"
"MC0066",808,671,1479,"MARICOPA",9,18,"#ffaaae"
"MC0067",151,90,241,"MARICOPA",4,22,"#eb4747"
"MC0068",366,977,1343,"MARICOPA",7,19,"#2222aa"
"MC0069",1652,1870,3522,"MARICOPA",8,30,"#aaaeff"
"MC0070",1366,902,2268,"MARICOPA",6,23,"#eb4747"
"MC0071",616,1391,2007,"MARICOPA",9,26,"#3333cc"
"MC0072",567,476,1043,"MARICOPA",8,20,"#ffaaae"
"MC0073",631,751,1382,"MARICOPA",6,28,"#aaaeff"
"MC0074",1399,887,2286,"MARICOPA",5,16,"#eb4747"
"MC0075",66,264,330,"MARICOPA",7,24,"#000066"
"MC0076",2077,1928,4005,"MARICOPA",9,18,"#ffd5d9"
"MC0077",1832,1036,2868,"MARICOPA",8,21,"#eb4747"
"MC0078",1779,890,2669,"MARICOPA",5,12,"#cc3333"
"MC0079",545,765,1310,"MARICOPA",9,18,"#8181f5"
"MC0080",2413,1068,3481,"MARICOPA",5,25,"#cc3333"
"MC0081",1200,1131,2331,"MARICOPA",6,20,"#ffd5d9"
"MC0082",141,83,224,"MARICOPA",4,23,"#eb4747"
"MC0083",1441,923,2364,"MARICOPA",5,16,"#eb4747"
"MC0084",367,884,1251,"MARICOPA",7,30,"#2222aa"
"MC0085",1231,1458,2689,"MARICOPA",9,18,"#aaaeff"
"MC0086",1802,889,2691,"MARICOPA",6,1,"#cc3333"
"MC0087",484,1119,1603,"MARICOPA",7,29,"#3333cc"
"MC0088",642,918,1560,"MARICOPA",9,17,"#8181f5"
"MC0089",1429,1030,2459,"MARICOPA",8,20,"#f58181"
"MC0090",860,841,1701,"MARICOPA",8,20,"#ffd5d9"
"MC0091",961,1160,2121,"MARICOPA",9,18,"#aaaeff"
"MC0092",755,1400,2155,"MARICOPA",7,27,"#4747eb"
"MC0093",727,1981,2708,"MARICOPA",3,19,"#2222aa"
"MC0094",1347,763,2110,"MARICOPA",5,12,"#eb4747"
"MC0095",1682,1475,3157,"MARICOPA",6,15,"#ffaaae"
"MC0096",1794,963,2757,"MARICOPA",6,1,"#cc3333"
"MC0097",615,1308,1923,"MARICOPA",9,18,"#3333cc"
"MC0098",564,594,1158,"MARICOPA",9,26,"#d5d9ff"
"MC0099",473,1318,1791,"MARICOPA",9,24,"#2222aa"
"MC0100",369,792,1161,"MARICOPA",7,29,"#3333cc"
"MC0101",2463,1498,3961,"MARICOPA",5,17,"#eb4747"
"MC0102",136,491,627,"MARICOPA",7,27,"#111188"
"MC0103",823,2145,2968,"MARICOPA",7,27,"#2222aa"
"MC0104",1795,897,2692,"MARICOPA",6,28,"#cc3333"
"MC0105",555,671,1226,"MARICOPA",9,18,"#aaaeff"
"MC0106",960,1107,2067,"MARICOPA",6,20,"#aaaeff"
"MC0107",582,519,1101,"MARICOPA",8,20,"#ffaaae"
"MC0108",1546,1163,2709,"MARICOPA",6,23,"#f58181"
"MC0109",960,856,1816,"MARICOPA",6,15,"#ffaaae"
"MC0110",680,1167,1847,"MARICOPA",9,28,"#4747eb"
"MC0111",1196,963,2159,"MARICOPA",5,25,"#f58181"
"MC0112",1677,1086,2763,"MARICOPA",5,25,"#eb4747"
"MC0113",336,155,491,"MARICOPA",6,1,"#cc3333"
"MC0114",1396,1205,2601,"MARICOPA",6,15,"#ffaaae"
"MC0115",669,392,1061,"MARICOPA",6,28,"#eb4747"
"MC0116",435,642,1077,"MARICOPA",9,28,"#8181f5"
"MC0117",1475,901,2376,"MARICOPA",5,17,"#eb4747"
"MC0118",332,337,669,"MARICOPA",9,25,"#d5d9ff"
"MC0119",2031,1890,3921,"MARICOPA",9,18,"#ffd5d9"
"MC0120",891,627,1518,"MARICOPA",6,23,"#f58181"
"MC0121",590,1174,1764,"MARICOPA",3,19,"#3333cc"
"MC0122",1984,1967,3951,"MARICOPA",5,17,"#ffd5d9"
"MC0123",821,1391,2212,"MARICOPA",9,24,"#4747eb"
"MC0124",266,589,855,"MARICOPA",7,29,"#3333cc"
"MC0125",1263,945,2208,"MARICOPA",8,21,"#f58181"
"MC0126",382,721,1103,"MARICOPA",9,17,"#3333cc"
"MC0127",2022,1842,3864,"MARICOPA",5,17,"#ffd5d9"
"MC0128",690,718,1408,"MARICOPA",9,17,"#d5d9ff"
"MC0129",634,672,1306,"MARICOPA",5,17,"#d5d9ff"
"MC0130",795,418,1213,"MARICOPA",8,22,"#cc3333"
"MC0131",501,524,1025,"MARICOPA",6,28,"#d5d9ff"
"MC0132",1230,958,2188,"MARICOPA",6,28,"#f58181"
"MC0133",569,532,1101,"MARICOPA",8,20,"#ffd5d9"
"MC0134",170,476,646,"MARICOPA",3,19,"#2222aa"
"MC0135",1346,1797,3143,"MARICOPA",9,18,"#8181f5"
"MC0136",183,476,659,"MARICOPA",3,19,"#2222aa"
"MC0137",561,921,1482,"MARICOPA",3,29,"#4747eb"
"MC0138",168,371,539,"MARICOPA",7,30,"#3333cc"
"MC0139",594,755,1349,"MARICOPA",9,18,"#8181f5"
"MC0140",1096,1311,2407,"MARICOPA",9,24,"#aaaeff"
"MC0141",1446,815,2261,"MARICOPA",8,21,"#eb4747"
"MC0142",328,435,763,"MARICOPA",6,30,"#8181f5"
"MC0143",1680,1253,2933,"MARICOPA",8,13,"#f58181"
"MC0144",2546,1496,4042,"MARICOPA",5,17,"#eb4747"
"MC0145",457,340,797,"MARICOPA",8,20,"#f58181"
"MC0146",286,273,559,"MARICOPA",8,29,"#ffd5d9"
"MC0147",1445,782,2227,"MARICOPA",5,25,"#eb4747"
"MC0148",773,609,1382,"MARICOPA",6,15,"#f58181"
"MC0149",1782,834,2616,"MARICOPA",8,22,"#cc3333"
"MC0150",997,619,1616,"MARICOPA",8,21,"#eb4747"
"MC0151",1735,1140,2875,"MARICOPA",8,15,"#eb4747"
"MC0152",518,1340,1858,"MARICOPA",7,24,"#2222aa"
"MC0153",717,355,1072,"MARICOPA",8,22,"#cc3333"
"MC0154",1608,1737,3345,"MARICOPA",9,18,"#d5d9ff"
"MC0155",814,497,1311,"MARICOPA",5,25,"#eb4747"
"MC0156",655,440,1095,"MARICOPA",8,21,"#f58181"
"MC0157",2184,1587,3771,"MARICOPA",5,12,"#f58181"
"MC0158",1204,1763,2967,"MARICOPA",3,19,"#8181f5"
"MC0159",867,802,1669,"MARICOPA",5,12,"#ffd5d9"
"MC0160",200,671,871,"MARICOPA",7,29,"#111188"
"MC0161",779,505,1284,"MARICOPA",8,20,"#eb4747"
"MC0162",677,554,1231,"MARICOPA",8,20,"#ffaaae"
"MC0163",1480,932,2412,"MARICOPA",5,16,"#eb4747"
"MC0164",1174,770,1944,"MARICOPA",6,15,"#eb4747"
"MC0165",555,1082,1637,"MARICOPA",9,17,"#3333cc"
"MC0166",383,940,1323,"MARICOPA",9,26,"#2222aa"
"MC0167",3113,2098,5211,"MARICOPA",6,23,"#f58181"
"MC0168",2457,785,3242,"MARICOPA",8,1,"#881111"
"MC0169",1125,710,1835,"MARICOPA",6,15,"#eb4747"
"MC0170",358,366,724,"MARICOPA",6,23,"#d5d9ff"
"MC0171",1599,1202,2801,"MARICOPA",6,23,"#f58181"
"MC0172",1062,1339,2401,"MARICOPA",9,18,"#8181f5"
"MC0173",913,1102,2015,"MARICOPA",6,20,"#aaaeff"
"MC0174",824,532,1356,"MARICOPA",3,4,"#eb4747"
"MC0175",707,956,1663,"MARICOPA",6,28,"#8181f5"
"MC0176",1404,1319,2723,"MARICOPA",8,4,"#ffd5d9"
"MC0177",1983,1350,3333,"MARICOPA",8,21,"#f58181"
"MC0178",2149,1328,3477,"MARICOPA",5,16,"#eb4747"
"MC0179",1619,698,2317,"MARICOPA",6,23,"#cc3333"
"MC0180",2040,746,2786,"MARICOPA",8,1,"#aa2222"
"MC0181",804,837,1641,"MARICOPA",7,29,"#d5d9ff"
"MC0182",2317,1023,3340,"MARICOPA",8,22,"#cc3333"
"MC0183",2718,1701,4419,"MARICOPA",8,15,"#eb4747"
"MC0184",303,885,1188,"MARICOPA",7,19,"#2222aa"
"MC0185",1468,1542,3010,"MARICOPA",8,4,"#d5d9ff"
"MC0186",764,710,1474,"MARICOPA",8,13,"#ffd5d9"
"MC0187",612,650,1262,"MARICOPA",9,18,"#d5d9ff"
"MC0188",319,815,1134,"MARICOPA",3,19,"#2222aa"
"MC0189",1631,1866,3497,"MARICOPA",3,19,"#aaaeff"
"MC0190",544,778,1322,"MARICOPA",9,26,"#8181f5"
"MC0191",3134,1836,4970,"MARICOPA",6,15,"#eb4747"
"MC0192",1380,2496,3876,"MARICOPA",7,27,"#4747eb"
"MC0193",757,631,1388,"MARICOPA",5,17,"#ffaaae"
"MC0194",1682,1985,3667,"MARICOPA",9,18,"#aaaeff"
"MC0195",1477,940,2417,"MARICOPA",6,28,"#eb4747"
"MC0196",1163,644,1807,"MARICOPA",6,1,"#eb4747"
"MC0197",517,691,1208,"MARICOPA",9,18,"#8181f5"
"MC0198",2394,1546,3940,"MARICOPA",5,25,"#eb4747"
"MC0199",582,877,1459,"MARICOPA",9,28,"#4747eb"
"MC0200",1124,979,2103,"MARICOPA",6,23,"#ffaaae"
"MC0201",2177,1379,3556,"MARICOPA",5,12,"#eb4747"
"MC0202",890,1040,1930,"MARICOPA",9,17,"#aaaeff"
"MC0203",806,946,1752,"MARICOPA",9,25,"#aaaeff"
"MC0204",159,719,878,"MARICOPA",7,27,"#000066"
"MC0205",819,669,1488,"MARICOPA",3,13,"#f58181"
"MC0206",3920,1821,5741,"MARICOPA",8,22,"#cc3333"
"MC0207",516,1120,1636,"MARICOPA",9,26,"#3333cc"
"MC0208",1646,1153,2799,"MARICOPA",6,15,"#f58181"
"MC0209",441,353,794,"MARICOPA",8,21,"#f58181"
"MC0210",573,420,993,"MARICOPA",5,16,"#f58181"
"MC0211",1045,687,1732,"MARICOPA",5,16,"#eb4747"
"MC0212",463,596,1059,"MARICOPA",6,30,"#8181f5"
"MC0213",206,881,1087,"MARICOPA",7,24,"#000066"
"MC0214",947,1507,2454,"MARICOPA",9,30,"#4747eb"
"MC0215",663,1061,1724,"MARICOPA",9,28,"#4747eb"
"MC0216",940,1312,2252,"MARICOPA",8,21,"#8181f5"
"MC0217",593,507,1100,"MARICOPA",9,26,"#ffaaae"
"MC0218",488,1418,1906,"MARICOPA",7,26,"#2222aa"
"MC0219",1371,846,2217,"MARICOPA",8,21,"#eb4747"
"MC0220",1189,1345,2534,"MARICOPA",5,17,"#aaaeff"
"MC0221",595,1716,2311,"MARICOPA",7,24,"#2222aa"
"MC0222",1603,937,2540,"MARICOPA",5,25,"#eb4747"
"MC0223",1426,673,2099,"MARICOPA",5,25,"#cc3333"
"MC0224",450,1409,1859,"MARICOPA",9,26,"#111188"
"MC0225",469,484,953,"MARICOPA",6,28,"#d5d9ff"
"MC0226",2091,1525,3616,"MARICOPA",5,16,"#f58181"
"MC0227",729,1393,2122,"MARICOPA",9,26,"#3333cc"
"MC0228",2192,1616,3808,"MARICOPA",3,4,"#f58181"
"MC0229",767,1657,2424,"MARICOPA",7,27,"#3333cc"
"MC0230",704,578,1282,"MARICOPA",6,15,"#ffaaae"
"MC0231",807,788,1595,"MARICOPA",9,25,"#ffd5d9"
"MC0232",2651,1507,4158,"MARICOPA",5,16,"#eb4747"
"MC0233",2576,1237,3813,"MARICOPA",5,16,"#cc3333"
"MC0234",2419,1288,3707,"MARICOPA",4,13,"#cc3333"
"MC0235",1398,1314,2712,"MARICOPA",5,17,"#ffd5d9"
"MC0236",1687,2172,3859,"MARICOPA",9,18,"#8181f5"
"MC0237",1888,1702,3590,"MARICOPA",9,18,"#ffaaae"
"MC0238",61,154,215,"MARICOPA",6,23,"#2222aa"
"MC0239",1471,835,2306,"MARICOPA",6,23,"#eb4747"
"MC0240",1944,1241,3185,"MARICOPA",6,23,"#eb4747"
"MC0241",1289,1410,2699,"MARICOPA",5,17,"#d5d9ff"
"MC0242",795,646,1441,"MARICOPA",6,28,"#f58181"
"MC0243",1147,633,1780,"MARICOPA",5,16,"#eb4747"
"MC0244",2317,1424,3741,"MARICOPA",8,22,"#eb4747"
"MC0245",3158,2470,5628,"MARICOPA",5,17,"#f58181"
"MC0246",1764,2296,4060,"MARICOPA",9,18,"#8181f5"
"MC0247",696,1159,1855,"MARICOPA",7,27,"#4747eb"
"MC0248",145,474,619,"MARICOPA",7,24,"#111188"
"MC0249",254,1212,1466,"MARICOPA",7,27,"#000066"
"MC0250",1586,867,2453,"MARICOPA",8,1,"#eb4747"
"MC0251",1056,929,1985,"MARICOPA",8,20,"#ffaaae"
"MC0252",1263,652,1915,"MARICOPA",5,25,"#cc3333"
"MC0253",1215,1181,2396,"MARICOPA",5,17,"#ffd5d9"
"MC0254",522,595,1117,"MARICOPA",9,17,"#aaaeff"
"MC0255",1056,1422,2478,"MARICOPA",9,17,"#8181f5"
"MC0256",250,171,421,"MARICOPA",3,4,"#f58181"
"MC0257",1167,962,2129,"MARICOPA",5,12,"#ffaaae"
"MC0258",1415,1230,2645,"MARICOPA",5,12,"#ffaaae"
"MC0259",758,726,1484,"MARICOPA",8,30,"#ffd5d9"
"MC0260",812,990,1802,"MARICOPA",9,28,"#aaaeff"
"MC0261",584,940,1524,"MARICOPA",9,24,"#4747eb"
"MC0262",1891,778,2669,"MARICOPA",5,25,"#aa2222"
"MC0263",625,581,1206,"MARICOPA",6,28,"#ffd5d9"
"MC0264",2165,1221,3386,"MARICOPA",6,23,"#eb4747"
"MC0265",1252,1017,2269,"MARICOPA",5,16,"#f58181"
"MC0266",144,60,204,"MARICOPA",4,23,"#aa2222"
"MC0267",334,491,825,"MARICOPA",8,4,"#8181f5"
"MC0268",445,1089,1534,"MARICOPA",7,30,"#2222aa"
"MC0269",2924,1736,4660,"MARICOPA",8,22,"#eb4747"
"MC0270",2164,1342,3506,"MARICOPA",8,22,"#eb4747"
"MC0271",2450,893,3343,"MARICOPA",6,23,"#aa2222"
"MC0272",1217,706,1923,"MARICOPA",6,23,"#eb4747"
"MC0273",1315,725,2040,"MARICOPA",8,22,"#eb4747"
"MC0274",268,1013,1281,"MARICOPA",7,27,"#111188"
"MC0275",2144,1445,3589,"MARICOPA",5,25,"#f58181"
"MC0276",1314,1184,2498,"MARICOPA",6,28,"#ffaaae"
"MC0277",848,444,1292,"MARICOPA",8,22,"#cc3333"
"MC0278",932,890,1822,"MARICOPA",6,20,"#ffd5d9"
"MC0279",1887,1059,2946,"MARICOPA",5,25,"#eb4747"
"MC0280",184,1120,1304,"MARICOPA",7,27,"#000066"
"MC0281",535,943,1478,"MARICOPA",9,26,"#4747eb"
"MC0282",345,776,1121,"MARICOPA",3,19,"#3333cc"
"MC0283",1061,1655,2716,"MARICOPA",9,28,"#4747eb"
"MC0284",503,206,709,"MARICOPA",8,22,"#aa2222"
"MC0285",1505,762,2267,"MARICOPA",8,15,"#cc3333"
"MC0286",1026,1381,2407,"MARICOPA",6,30,"#8181f5"
"MC0287",1668,1113,2781,"MARICOPA",5,25,"#f58181"
"MC0288",62,41,103,"MARICOPA",3,13,"#eb4747"
"MC0289",262,326,588,"MARICOPA",5,25,"#8181f5"
"MC0290",92,493,585,"MARICOPA",7,19,"#000066"
"MC0291",72,57,129,"MARICOPA",3,13,"#f58181"
"MC0292",1443,814,2257,"MARICOPA",8,1,"#eb4747"
"MC0293",768,923,1691,"MARICOPA",9,28,"#aaaeff"
"MC0294",1031,678,1709,"MARICOPA",5,16,"#eb4747"
"MC0295",156,745,901,"MARICOPA",7,30,"#000066"
"MC0296",733,1088,1821,"MARICOPA",9,26,"#8181f5"
"MC0297",381,1590,1971,"MARICOPA",7,27,"#000066"
"MC0298",2762,1356,4118,"MARICOPA",5,25,"#cc3333"
"MC0299",2,25,27,"MARICOPA",3,4,"#000066"
"MC0300",463,1393,1856,"MARICOPA",7,27,"#111188"
"MC0301",2337,1326,3663,"MARICOPA",5,12,"#eb4747"
"MC0302",2240,1456,3696,"MARICOPA",5,12,"#eb4747"
"MC0303",1355,825,2180,"MARICOPA",8,22,"#eb4747"
"MC0304",1227,811,2038,"MARICOPA",6,15,"#eb4747"
"MC0305",1477,1155,2632,"MARICOPA",6,15,"#f58181"
"MC0306",108,367,475,"MARICOPA",7,27,"#111188"
"MC0307",789,880,1669,"MARICOPA",9,25,"#aaaeff"
"MC0308",153,455,608,"MARICOPA",7,29,"#2222aa"
"MC0309",466,1400,1866,"MARICOPA",7,29,"#111188"
"MC0310",681,1223,1904,"MARICOPA",9,26,"#4747eb"
"MC0311",247,672,919,"MARICOPA",7,24,"#2222aa"
"MC0312",296,946,1242,"MARICOPA",7,29,"#111188"
"MC0313",375,1174,1549,"MARICOPA",7,29,"#111188"
"MC0314",550,990,1540,"MARICOPA",6,26,"#4747eb"
"MC0315",392,1431,1823,"MARICOPA",7,27,"#111188"
"MC0316",1131,786,1917,"MARICOPA",3,4,"#f58181"
"MC0317",1267,943,2210,"MARICOPA",9,28,"#f58181"
"MC0318",1988,1550,3538,"MARICOPA",6,15,"#f58181"
"MC0319",1932,1328,3260,"MARICOPA",6,23,"#f58181"
"MC0320",613,745,1358,"MARICOPA",9,24,"#aaaeff"
"MC0321",382,1291,1673,"MARICOPA",9,26,"#111188"
"MC0322",790,1169,1959,"MARICOPA",7,29,"#8181f5"
"MC0323",872,960,1832,"MARICOPA",6,28,"#d5d9ff"
"MC0324",705,1365,2070,"MARICOPA",9,26,"#3333cc"
"MC0325",1578,803,2381,"MARICOPA",8,22,"#cc3333"
"MC0326",106,488,594,"MARICOPA",7,30,"#000066"
"MC0327",2279,1850,4129,"MARICOPA",5,12,"#f58181"
"MC0328",1460,1216,2676,"MARICOPA",6,15,"#ffaaae"
"MC0329",706,769,1475,"MARICOPA",6,28,"#d5d9ff"
"MC0330",805,389,1194,"MARICOPA",8,21,"#cc3333"
"MC0331",811,989,1800,"MARICOPA",9,17,"#aaaeff"
"MC0332",707,1349,2056,"MARICOPA",9,26,"#3333cc"
"MC0333",1452,919,2371,"MARICOPA",8,22,"#eb4747"
"MC0334",1405,1182,2587,"MARICOPA",8,15,"#ffaaae"
"MC0335",660,376,1036,"MARICOPA",6,20,"#eb4747"
"MC0336",1251,1540,2791,"MARICOPA",9,18,"#8181f5"
"MC0337",1355,1066,2421,"MARICOPA",6,15,"#f58181"
"MC0338",1028,1471,2499,"MARICOPA",9,28,"#8181f5"
"MC0339",1093,771,1864,"MARICOPA",9,28,"#f58181"
"MC0340",1174,1475,2649,"MARICOPA",7,30,"#8181f5"
"MC0341",701,1145,1846,"MARICOPA",7,30,"#4747eb"
"MC0342",2019,1253,3272,"MARICOPA",8,21,"#eb4747"
"MC0343",691,434,1125,"MARICOPA",6,15,"#eb4747"
"MC0344",1264,997,2261,"MARICOPA",6,20,"#f58181"
"MC0345",558,337,895,"MARICOPA",6,28,"#eb4747"
"MC0346",891,1400,2291,"MARICOPA",9,26,"#4747eb"
"MC0347",738,412,1150,"MARICOPA",8,22,"#eb4747"
"MC0348",1413,1849,3262,"MARICOPA",9,18,"#8181f5"
"MC0349",59,188,247,"MARICOPA",1,27,"#111188"
"MC0350",635,679,1314,"MARICOPA",3,19,"#d5d9ff"
"MC0351",2708,1494,4202,"MARICOPA",8,22,"#eb4747"
"MC0352",2536,1214,3750,"MARICOPA",8,22,"#cc3333"
"MC0353",772,450,1222,"MARICOPA",8,21,"#eb4747"
"MC0354",1496,1693,3189,"MARICOPA",9,18,"#aaaeff"
"MC0355",628,711,1339,"MARICOPA",9,28,"#aaaeff"
"MC0356",2046,1791,3837,"MARICOPA",5,17,"#ffaaae"
"MC0357",1400,1220,2620,"MARICOPA",5,17,"#ffaaae"
"MC0358",1612,1015,2627,"MARICOPA",5,12,"#eb4747"
"MC0359",2451,1281,3732,"MARICOPA",5,25,"#cc3333"
"MC0360",449,1207,1656,"MARICOPA",7,27,"#2222aa"
"MC0361",790,569,1359,"MARICOPA",6,23,"#f58181"
"MC0362",334,945,1279,"MARICOPA",7,27,"#2222aa"
"MC0363",979,2226,3205,"MARICOPA",7,27,"#3333cc"
"MC0364",223,162,385,"MARICOPA",5,17,"#f58181"
"MC0365",982,483,1465,"MARICOPA",5,25,"#cc3333"
"MC0366",1323,729,2052,"MARICOPA",5,25,"#eb4747"
"MC0367",205,576,781,"MARICOPA",7,30,"#2222aa"
"MC0368",843,561,1404,"MARICOPA",6,15,"#eb4747"
"MC0369",818,467,1285,"MARICOPA",3,13,"#eb4747"
"MC0370",1177,820,1997,"MARICOPA",8,15,"#f58181"
"MC0371",688,570,1258,"MARICOPA",8,13,"#ffaaae"
"MC0372",1129,728,1857,"MARICOPA",5,16,"#eb4747"
"MC0373",1153,994,2147,"MARICOPA",6,20,"#ffaaae"
"MC0374",695,1618,2313,"MARICOPA",9,24,"#3333cc"
"MC0375",1117,542,1659,"MARICOPA",6,23,"#cc3333"
"MC0376",2,6,8,"MARICOPA",1,27,"#111188"
"MC0377",3567,1823,5390,"MARICOPA",6,15,"#cc3333"
"MC0378",308,971,1279,"MARICOPA",3,19,"#111188"
"MC0379",1400,643,2043,"MARICOPA",5,25,"#cc3333"
"MC0380",1617,1492,3109,"MARICOPA",5,17,"#ffd5d9"
"MC0381",273,448,721,"MARICOPA",9,26,"#4747eb"
"MC0382",1316,1122,2438,"MARICOPA",9,28,"#ffaaae"
"MC0383",1431,615,2046,"MARICOPA",5,25,"#cc3333"
"MC0384",1901,1227,3128,"MARICOPA",8,22,"#eb4747"
"MC0385",176,506,682,"MARICOPA",7,27,"#2222aa"
"MC0386",2239,1691,3930,"MARICOPA",8,21,"#f58181"
"MC0387",626,1246,1872,"MARICOPA",7,30,"#3333cc"
"MC0388",742,723,1465,"MARICOPA",8,13,"#ffd5d9"
"MC0389",194,941,1135,"MARICOPA",7,30,"#000066"
"MC0390",834,842,1676,"MARICOPA",9,28,"#d5d9ff"
"MC0391",707,1903,2610,"MARICOPA",9,24,"#2222aa"
"MC0392",252,867,1119,"MARICOPA",7,30,"#111188"
"MC0393",746,600,1346,"MARICOPA",6,20,"#f58181"
"MC0394",1736,2226,3962,"MARICOPA",9,18,"#8181f5"
"MC0395",1581,860,2441,"MARICOPA",8,1,"#eb4747"
"MC0396",976,812,1788,"MARICOPA",6,20,"#ffaaae"
"MC0397",469,785,1254,"MARICOPA",7,30,"#4747eb"
"MC0398",510,542,1052,"MARICOPA",6,30,"#d5d9ff"
"MC0399",993,1206,2199,"MARICOPA",6,23,"#aaaeff"
"MC0400",600,650,1250,"MARICOPA",6,20,"#d5d9ff"
"MC0401",561,765,1326,"MARICOPA",3,29,"#8181f5"
"MC0402",411,1207,1618,"MARICOPA",7,29,"#2222aa"
"MC0403",1009,1706,2715,"MARICOPA",7,24,"#4747eb"
"MC0404",1161,894,2055,"MARICOPA",8,21,"#f58181"
"MC0405",360,172,532,"MARICOPA",3,13,"#cc3333"
"MC0406",384,674,1058,"MARICOPA",7,30,"#4747eb"
"MC0407",361,988,1349,"MARICOPA",7,29,"#2222aa"
"MC0408",947,1526,2473,"MARICOPA",9,24,"#4747eb"
"MC0409",338,396,734,"MARICOPA",5,26,"#aaaeff"
"MC0410",2461,2154,4615,"MARICOPA",6,23,"#ffaaae"
"MC0411",346,363,709,"MARICOPA",6,23,"#d5d9ff"
"MC0412",219,1021,1240,"MARICOPA",7,24,"#000066"
"MC0413",921,1226,2147,"MARICOPA",9,24,"#8181f5"
"MC0414",1074,1278,2352,"MARICOPA",9,18,"#aaaeff"
"MC0415",3362,2349,5711,"MARICOPA",5,17,"#f58181"
"MC0416",2195,1715,3910,"MARICOPA",5,12,"#f58181"
"MC0417",541,335,876,"MARICOPA",5,25,"#eb4747"
"MC0418",688,678,1366,"MARICOPA",5,26,"#ffd5d9"
"MC0419",1270,1078,2348,"MARICOPA",5,25,"#ffaaae"
"MC0420",2542,1532,4074,"MARICOPA",8,22,"#eb4747"
"MC0421",407,589,996,"MARICOPA",6,20,"#8181f5"
"MC0422",598,416,1014,"MARICOPA",6,20,"#f58181"
"MC0423",1993,1119,3112,"MARICOPA",8,21,"#eb4747"
"MC0424",167,536,703,"MARICOPA",7,29,"#111188"
"MC0425",1754,1731,3485,"MARICOPA",6,23,"#ffd5d9"
"MC0426",1118,1273,2391,"MARICOPA",9,17,"#aaaeff"
"MC0427",315,1187,1502,"MARICOPA",9,26,"#111188"
"MC0428",25,10,35,"MARICOPA",3,4,"#aa2222"
"MC0429",1363,1309,2672,"MARICOPA",6,23,"#ffd5d9"
"MC0430",830,539,1369,"MARICOPA",6,15,"#eb4747"
"MC0431",393,1110,1503,"MARICOPA",7,27,"#2222aa"
"MC0432",1836,1677,3513,"MARICOPA",6,20,"#ffd5d9"
"MC0433",190,613,803,"MARICOPA",7,19,"#111188"
"MC0434",279,560,839,"MARICOPA",7,29,"#3333cc"
"MC0435",1923,1014,2937,"MARICOPA",8,22,"#cc3333"
"MC0436",1337,924,2261,"MARICOPA",6,20,"#f58181"
"MC0437",441,150,591,"MARICOPA",4,13,"#aa2222"
"MC0438",1479,1444,2923,"MARICOPA",6,20,"#ffd5d9"
"MC0439",2146,1002,3148,"MARICOPA",4,22,"#cc3333"
"MC0440",1389,1394,2783,"MARICOPA",6,28,"#d5d9ff"
"MC0441",1743,1886,3629,"MARICOPA",5,17,"#d5d9ff"
"MC0442",1917,1465,3382,"MARICOPA",6,23,"#f58181"
"MC0443",1479,1303,2782,"MARICOPA",5,17,"#ffaaae"
"MC0444",2241,855,3096,"MARICOPA",8,1,"#aa2222"
"MC0445",638,830,1468,"MARICOPA",6,30,"#8181f5"
"MC0446",1215,995,2210,"MARICOPA",5,17,"#ffaaae"
"MC0447",2810,1935,4745,"MARICOPA",6,15,"#f58181"
"MC0448",489,1540,2029,"MARICOPA",7,24,"#111188"
"MC0449",150,226,376,"MARICOPA",6,28,"#4747eb"
"MC0450",183,326,509,"MARICOPA",5,25,"#4747eb"
"MC0451",580,745,1325,"MARICOPA",9,18,"#8181f5"
"MC0452",467,342,809,"MARICOPA",6,15,"#f58181"
"MC0453",1521,1719,3240,"MARICOPA",9,28,"#aaaeff"
"MC0454",2972,1517,4489,"MARICOPA",5,17,"#cc3333"
"MC0455",3023,1745,4768,"MARICOPA",5,16,"#eb4747"
"MC0456",301,549,850,"MARICOPA",7,30,"#4747eb"
"MC0457",959,895,1854,"MARICOPA",5,25,"#ffd5d9"
"MC0458",1340,817,2157,"MARICOPA",8,21,"#eb4747"
"MC0459",679,1101,1780,"MARICOPA",7,27,"#4747eb"
"MC0460",881,1040,1921,"MARICOPA",6,28,"#aaaeff"
"MC0461",1143,1637,2780,"MARICOPA",9,18,"#8181f5"
"MC0462",662,435,1097,"MARICOPA",6,28,"#eb4747"
"MC0463",599,887,1486,"MARICOPA",9,24,"#8181f5"
"MC0464",1785,1468,3253,"MARICOPA",3,13,"#ffaaae"
"MC0465",879,1421,2300,"MARICOPA",3,19,"#4747eb"
"MC0466",965,1102,2067,"MARICOPA",8,21,"#aaaeff"
"MC0467",980,616,1596,"MARICOPA",5,16,"#eb4747"
"MC0468",1196,654,1850,"MARICOPA",5,25,"#eb4747"
"MC0469",900,1408,2308,"MARICOPA",6,24,"#4747eb"
"MC0470",1589,879,2468,"MARICOPA",6,23,"#eb4747"
"MC0471",104,100,204,"MARICOPA",5,25,"#ffd5d9"
"MC0472",933,750,1683,"MARICOPA",8,13,"#f58181"
"MC0473",440,600,1040,"MARICOPA",9,28,"#8181f5"
"MC0474",1052,1355,2407,"MARICOPA",3,19,"#8181f5"
"MC0475",266,874,1140,"MARICOPA",7,27,"#111188"
"MC0476",750,1420,2170,"MARICOPA",9,26,"#3333cc"
"MC0477",1243,928,2171,"MARICOPA",5,12,"#f58181"
"MC0478",1256,743,1999,"MARICOPA",6,28,"#eb4747"
"MC0479",1616,1639,3255,"MARICOPA",8,20,"#d5d9ff"
"MC0480",1013,1210,2223,"MARICOPA",6,28,"#aaaeff"
"MC0481",291,718,1009,"MARICOPA",9,24,"#2222aa"
"MC0482",397,1224,1621,"MARICOPA",7,24,"#111188"
"MC0483",485,311,796,"MARICOPA",8,22,"#eb4747"
"MC0484",856,736,1592,"MARICOPA",6,28,"#ffaaae"
"MC0485",811,2570,3381,"MARICOPA",7,24,"#111188"
"MC0486",718,465,1183,"MARICOPA",6,23,"#eb4747"
"MC0487",1872,1244,3116,"MARICOPA",8,22,"#eb4747"
"MC0488",1466,787,2253,"MARICOPA",5,16,"#cc3333"
"MC0489",1463,702,2165,"MARICOPA",6,23,"#cc3333"
"MC0490",4447,2524,6971,"MARICOPA",8,13,"#eb4747"
"MC0491",218,511,729,"MARICOPA",7,29,"#2222aa"
"MC0492",1992,1967,3959,"MARICOPA",6,23,"#ffd5d9"
"MC0493",38,106,144,"MARICOPA",1,27,"#2222aa"
"MC0494",1047,609,1656,"MARICOPA",5,12,"#eb4747"
"MC0495",331,1001,1332,"MARICOPA",3,19,"#111188"
"MC0496",233,385,618,"MARICOPA",9,26,"#4747eb"
"MC0497",607,761,1368,"MARICOPA",8,21,"#8181f5"
"MC0498",560,1254,1814,"MARICOPA",9,27,"#3333cc"
"MC0499",376,890,1266,"MARICOPA",7,24,"#2222aa"
"MC0500",970,613,1583,"MARICOPA",8,20,"#eb4747"
"MC0501",861,948,1809,"MARICOPA",9,28,"#d5d9ff"
"MC0502",437,833,1270,"MARICOPA",7,24,"#3333cc"
"MC0503",1827,1486,3313,"MARICOPA",5,25,"#f58181"
"MC0504",1060,1108,2168,"MARICOPA",6,23,"#d5d9ff"
"MC0505",1522,1014,2536,"MARICOPA",6,23,"#eb4747"
"MC0506",3938,1713,5651,"MARICOPA",6,23,"#cc3333"
"MC0507",1436,876,2312,"MARICOPA",6,23,"#eb4747"
"MC0508",1434,1435,2869,"MARICOPA",5,12,"#d5d9ff"
"MC0509",1461,1211,2672,"MARICOPA",9,18,"#ffaaae"
"MC0510",778,529,1307,"MARICOPA",8,20,"#f58181"
"MC0511",1406,1041,2447,"MARICOPA",5,12,"#f58181"
"MC0512",1292,626,1918,"MARICOPA",5,12,"#cc3333"
"MC0513",407,346,753,"MARICOPA",8,20,"#ffaaae"
"MC0514",577,601,1178,"MARICOPA",6,20,"#d5d9ff"
"MC0515",721,838,1559,"MARICOPA",6,20,"#aaaeff"
"MC0516",967,679,1646,"MARICOPA",9,25,"#f58181"
"MC0517",1848,1208,3056,"MARICOPA",5,16,"#eb4747"
"MC0518",2024,1444,3468,"MARICOPA",5,12,"#f58181"
"MC0519",1170,1672,2842,"MARICOPA",6,23,"#8181f5"
"MC0520",1087,1190,2277,"MARICOPA",7,29,"#d5d9ff"
"MC0521",3637,2274,5911,"MARICOPA",8,15,"#eb4747"
"MC0522",1991,1808,3799,"MARICOPA",6,15,"#ffd5d9"
"MC0523",1801,673,2474,"MARICOPA",5,12,"#aa2222"
"MC0524",728,420,1148,"MARICOPA",3,4,"#eb4747"
"MC0525",898,1764,2662,"MARICOPA",9,24,"#3333cc"
"MC0526",1315,1429,2744,"MARICOPA",8,21,"#d5d9ff"
"MC0527",1508,812,2320,"MARICOPA",6,1,"#cc3333"
"MC0528",308,611,919,"MARICOPA",7,29,"#3333cc"
"MC0529",1769,1122,2891,"MARICOPA",5,25,"#eb4747"
"MC0530",551,822,1373,"MARICOPA",9,18,"#8181f5"
"MC0531",1110,1250,2360,"MARICOPA",6,23,"#aaaeff"
"MC0532",394,496,890,"MARICOPA",5,26,"#8181f5"
"MC0533",2205,1648,3853,"MARICOPA",8,22,"#f58181"
"MC0534",534,493,1027,"MARICOPA",6,23,"#ffd5d9"
"MC0535",861,701,1562,"MARICOPA",5,12,"#f58181"
"MC0536",1385,851,2236,"MARICOPA",8,22,"#eb4747"
"MC0537",1216,794,2010,"MARICOPA",6,23,"#eb4747"
"MC0538",1071,876,1947,"MARICOPA",8,13,"#f58181"
"MC0539",511,1535,2046,"MARICOPA",9,26,"#111188"
"MC0540",2705,972,3677,"MARICOPA",6,23,"#aa2222"
"MC0541",2693,1153,3846,"MARICOPA",5,12,"#aa2222"
"MC0542",365,1254,1619,"MARICOPA",7,19,"#111188"
"MC0543",910,1103,2013,"MARICOPA",9,26,"#aaaeff"
"MC0544",684,517,1201,"MARICOPA",8,20,"#f58181"
"MC0545",171,599,770,"MARICOPA",7,29,"#111188"
"MC0546",1686,1583,3269,"MARICOPA",9,18,"#ffd5d9"
"MC0547",411,449,860,"MARICOPA",6,20,"#d5d9ff"
"MC0548",585,1726,2311,"MARICOPA",7,27,"#2222aa"
"MC0549",675,1250,1925,"MARICOPA",9,26,"#4747eb"
"MC0550",718,1783,2501,"MARICOPA",3,29,"#2222aa"
"MC0551",1613,1497,3110,"MARICOPA",6,20,"#ffd5d9"
"MC0552",579,559,1138,"MARICOPA",6,15,"#ffd5d9"
"MC0553",1136,1634,2770,"MARICOPA",9,18,"#8181f5"
"MC0554",773,1176,1949,"MARICOPA",9,28,"#4747eb"
"MC0555",1310,944,2254,"MARICOPA",8,21,"#f58181"
"MC0556",1019,2036,3055,"MARICOPA",9,24,"#3333cc"
"MC0557",2066,1047,3113,"MARICOPA",8,21,"#cc3333"
"MC0558",2704,1604,4308,"MARICOPA",5,12,"#eb4747"
"MC0559",1978,988,2966,"MARICOPA",6,23,"#cc3333"
"MC0560",686,636,1322,"MARICOPA",8,20,"#ffd5d9"
"MC0561",278,70,348,"MARICOPA",4,13,"#881111"
"MC0562",853,1043,1896,"MARICOPA",9,24,"#8181f5"
"MC0563",1053,677,1730,"MARICOPA",5,12,"#eb4747"
"MC0564",13,53,66,"MARICOPA",3,4,"#000066"
"MC0565",616,876,1492,"MARICOPA",9,17,"#8181f5"
"MC0566",1939,1250,3189,"MARICOPA",5,25,"#eb4747"
"MC0567",265,378,643,"MARICOPA",8,29,"#8181f5"
"MC0568",97,79,176,"MARICOPA",5,25,"#f58181"
"MC0569",593,542,1135,"MARICOPA",5,17,"#ffd5d9"
"MC0570",528,553,1081,"MARICOPA",6,23,"#d5d9ff"
"MC0571",912,857,1769,"MARICOPA",6,23,"#ffd5d9"
"MC0572",984,1231,2215,"MARICOPA",9,18,"#8181f5"
"MC0573",1266,823,2089,"MARICOPA",6,15,"#eb4747"
"MC0574",695,658,1353,"MARICOPA",3,19,"#ffd5d9"
"MC0575",198,615,813,"MARICOPA",7,19,"#111188"
"MC0576",1140,388,1528,"MARICOPA",5,12,"#aa2222"
"MC0577",1331,1030,2361,"MARICOPA",6,23,"#f58181"
"MC0578",1107,740,1847,"MARICOPA",8,21,"#f58181"
"MC0579",1130,769,1899,"MARICOPA",8,22,"#f58181"
"MC0580",1707,1670,3377,"MARICOPA",6,23,"#ffd5d9"
"MC0581",1220,1726,2946,"MARICOPA",9,18,"#8181f5"
"MC0582",499,1422,1921,"MARICOPA",7,19,"#2222aa"
"MC0583",24,12,36,"MARICOPA",3,4,"#cc3333"
"MC0584",1385,1181,2566,"MARICOPA",6,23,"#ffaaae"
"MC0585",833,1667,2500,"MARICOPA",7,30,"#3333cc"
"MC0586",2485,1590,4075,"MARICOPA",5,12,"#eb4747"
"MC0587",1145,1038,2183,"MARICOPA",6,28,"#ffd5d9"
"MC0588",674,539,1213,"MARICOPA",6,20,"#f58181"
"MC0589",740,1057,1797,"MARICOPA",9,26,"#8181f5"
"MC0590",1719,980,2699,"MARICOPA",8,21,"#eb4747"
"MC0591",896,946,1842,"MARICOPA",6,28,"#d5d9ff"
"MC0592",694,688,1382,"MARICOPA",6,28,"#ffd5d9"
"MC0593",1226,1197,2423,"MARICOPA",6,28,"#ffd5d9"
"MC0594",1706,1069,2775,"MARICOPA",6,23,"#eb4747"
"MC0595",1272,1084,2356,"MARICOPA",5,12,"#ffaaae"
"MC0596",1827,1667,3494,"MARICOPA",6,15,"#ffd5d9"
"MC0597",813,565,1378,"MARICOPA",8,22,"#f58181"
"MC0598",383,1291,1674,"MARICOPA",7,27,"#111188"
"MC0599",598,477,1075,"MARICOPA",6,15,"#f58181"
"MC0600",2243,1526,3769,"MARICOPA",6,23,"#f58181"
"MC0601",701,1800,2501,"MARICOPA",7,30,"#2222aa"
"MC0602",838,1386,2224,"MARICOPA",9,28,"#4747eb"
"MC0603",820,392,1212,"MARICOPA",8,22,"#cc3333"
"MC0604",796,613,1409,"MARICOPA",8,21,"#f58181"
"MC0605",1,2,3,"MARICOPA",7,27,"#3333cc"
"MC0606",2,4,6,"MARICOPA",7,27,"#3333cc"
"MC0607",10,11,21,"MARICOPA",7,27,"#d5d9ff"
"MC0608",729,1587,2316,"MARICOPA",7,24,"#3333cc"
"MC0609",511,626,1137,"MARICOPA",9,28,"#8181f5"
"MC0610",633,1132,1765,"MARICOPA",8,21,"#4747eb"
"MC0611",2505,962,3467,"MARICOPA",5,12,"#aa2222"
"MC0612",3359,1516,4875,"MARICOPA",5,12,"#cc3333"
"MC0613",239,892,1131,"MARICOPA",7,27,"#111188"
"MC0614",78,121,199,"MARICOPA",7,27,"#4747eb"
"MC0620",312,1414,1726,"MARICOPA",7,27,"#000066"
"MC0621",1091,621,1712,"MARICOPA",8,22,"#eb4747"
"MC0622",545,667,1212,"MARICOPA",9,17,"#8181f5"
"MC0623",208,306,514,"MARICOPA",9,28,"#8181f5"
"MC0624",2091,1555,3646,"MARICOPA",5,12,"#f58181"
"MC0625",67,25,92,"MARICOPA",4,1,"#aa2222"
"MC0626",698,404,1102,"MARICOPA",8,21,"#eb4747"
"MC0627",475,734,1209,"MARICOPA",9,24,"#4747eb"
"MC0628",841,642,1483,"MARICOPA",8,20,"#f58181"
"MC0629",735,407,1142,"MARICOPA",8,22,"#eb4747"
"MC0630",281,756,1037,"MARICOPA",7,29,"#2222aa"
"MC0631",423,773,1196,"MARICOPA",7,30,"#4747eb"
"MC0632",1646,1755,3401,"MARICOPA",9,18,"#d5d9ff"
"MC0633",988,633,1621,"MARICOPA",6,23,"#eb4747"
"MC0634",19,14,33,"MARICOPA",5,16,"#f58181"
"MC0635",755,2251,3006,"MARICOPA",3,19,"#2222aa"
"MC0636",798,467,1265,"MARICOPA",8,22,"#eb4747"
"MC0637",1583,1185,2768,"MARICOPA",8,21,"#f58181"
"MC0638",1438,850,2288,"MARICOPA",8,21,"#eb4747"
"MC0639",200,479,679,"MARICOPA",9,26,"#2222aa"
"MC0640",1253,1121,2374,"MARICOPA",5,17,"#ffaaae"
"MC0641",1263,748,2011,"MARICOPA",5,17,"#eb4747"
"MC0642",1879,1160,3039,"MARICOPA",5,25,"#eb4747"
"MC0643",663,569,1232,"MARICOPA",8,20,"#ffaaae"
"MC0644",1368,1263,2631,"MARICOPA",8,21,"#ffd5d9"
"MC0645",599,558,1157,"MARICOPA",8,21,"#ffd5d9"
"MC0646",1544,1210,2754,"MARICOPA",3,13,"#f58181"
"MC0647",1061,870,1931,"MARICOPA",6,23,"#ffaaae"
"MC0648",3,0,3,"MARICOPA",4,23,"#660000"
"MC0649",246,960,1206,"MARICOPA",7,27,"#111188"
"MC0650",2711,1716,4427,"MARICOPA",5,16,"#eb4747"
"MC0651",1636,1980,3616,"MARICOPA",9,28,"#aaaeff"
"MC0652",561,407,968,"MARICOPA",6,15,"#f58181"
"MC0653",391,697,1088,"MARICOPA",9,28,"#4747eb"
"MC0654",2047,1154,3201,"MARICOPA",5,12,"#eb4747"
"MC0655",1128,1015,2143,"MARICOPA",6,20,"#ffaaae"
"MC0656",691,660,1351,"MARICOPA",8,20,"#ffd5d9"
"MC0657",407,575,982,"MARICOPA",9,24,"#8181f5"
"MC0658",375,646,1021,"MARICOPA",8,21,"#4747eb"
"MC0659",2347,1507,3854,"MARICOPA",8,22,"#eb4747"
"MC0660",820,683,1503,"MARICOPA",6,23,"#ffaaae"
"MC0661",979,837,1816,"MARICOPA",8,21,"#ffaaae"
"MC0662",26,8,34,"MARICOPA",4,1,"#881111"
"MC0663",1167,806,1973,"MARICOPA",6,15,"#f58181"
"MC0664",941,478,1419,"MARICOPA",4,13,"#cc3333"
"MC0665",2937,2476,5413,"MARICOPA",6,15,"#ffaaae"
"MC0666",2486,1288,3774,"MARICOPA",6,23,"#cc3333"
"MC0667",237,348,585,"MARICOPA",9,24,"#8181f5"
"MC0668",927,482,1409,"MARICOPA",5,25,"#cc3333"
"MC0669",1640,862,2502,"MARICOPA",5,12,"#cc3333"
"MC0670",355,1154,1509,"MARICOPA",7,19,"#111188"
"MC0671",628,257,885,"MARICOPA",3,13,"#aa2222"
"MC0672",1877,1160,3037,"MARICOPA",5,25,"#eb4747"
"MC0673",8,4,12,"MARICOPA",4,23,"#cc3333"
"MC0674",1194,734,1928,"MARICOPA",5,12,"#eb4747"
"MC0675",190,384,574,"MARICOPA",9,30,"#3333cc"
"MC0676",1493,776,2269,"MARICOPA",8,22,"#cc3333"
"MC0677",2335,1585,3920,"MARICOPA",8,1,"#f58181"
"MC0678",201,714,915,"MARICOPA",7,29,"#111188"
"MC0679",4160,2475,6635,"MARICOPA",5,12,"#eb4747"
"MC0680",191,414,605,"MARICOPA",7,29,"#3333cc"
"MC0681",796,1437,2233,"MARICOPA",9,18,"#4747eb"
"MC0682",344,1113,1457,"MARICOPA",7,19,"#111188"
"MC0683",469,435,904,"MARICOPA",6,20,"#ffd5d9"
"MC0684",622,2155,2777,"MARICOPA",7,24,"#111188"
"MC0685",4398,2485,6883,"MARICOPA",4,13,"#eb4747"
"MC0686",498,1205,1703,"MARICOPA",9,26,"#2222aa"
"MC0687",124,130,254,"MARICOPA",3,4,"#d5d9ff"
"MC0688",1250,761,2011,"MARICOPA",5,25,"#eb4747"
"MC0689",535,717,1252,"MARICOPA",9,26,"#8181f5"
"MC0690",1234,1110,2344,"MARICOPA",8,21,"#ffaaae"
"MC0691",517,539,1056,"MARICOPA",5,17,"#d5d9ff"
"MC0692",1029,1130,2159,"MARICOPA",9,17,"#d5d9ff"
"MC0693",674,986,1660,"MARICOPA",7,29,"#8181f5"
"MC0694",402,753,1155,"MARICOPA",9,26,"#3333cc"
"MC0695",550,666,1216,"MARICOPA",3,29,"#aaaeff"
"MC0696",801,700,1501,"MARICOPA",6,15,"#ffaaae"
"MC0697",626,1125,1751,"MARICOPA",7,27,"#4747eb"
"MC0698",800,1195,1995,"MARICOPA",9,24,"#8181f5"
"MC0699",1146,1068,2214,"MARICOPA",6,28,"#ffd5d9"
"MC0700",224,91,315,"MARICOPA",4,23,"#aa2222"
"MC0701",3013,1776,4789,"MARICOPA",8,22,"#eb4747"
"MC0702",1199,1232,2431,"MARICOPA",8,21,"#d5d9ff"
"MC0703",1145,787,1932,"MARICOPA",8,21,"#f58181"
"MC0704",3745,1709,5454,"MARICOPA",8,13,"#cc3333"
"MC0705",1421,1651,3072,"MARICOPA",9,18,"#aaaeff"
"MC0706",1435,1051,2486,"MARICOPA",8,22,"#f58181"
"MC0707",746,1515,2261,"MARICOPA",3,19,"#3333cc"
"MC0708",1040,1282,2322,"MARICOPA",9,18,"#8181f5"
"MC0709",519,204,723,"MARICOPA",3,13,"#aa2222"
"MC0710",225,525,750,"MARICOPA",3,19,"#3333cc"
"MC0711",607,659,1266,"MARICOPA",9,18,"#d5d9ff"
"MC0712",531,1020,1551,"MARICOPA",7,30,"#3333cc"
"MC0713",2311,1779,4090,"MARICOPA",8,21,"#f58181"
"MC0714",3609,1942,5551,"MARICOPA",8,22,"#cc3333"
"MC0715",1440,919,2359,"MARICOPA",3,4,"#eb4747"
"MC0716",1954,1018,2972,"MARICOPA",8,22,"#cc3333"
"MC0717",948,1375,2323,"MARICOPA",9,18,"#8181f5"
"MC0718",897,859,1756,"MARICOPA",8,21,"#ffd5d9"
"MC0719",345,946,1291,"MARICOPA",7,19,"#2222aa"
"MC0720",513,2057,2570,"MARICOPA",7,24,"#000066"
"MC0721",1030,699,1729,"MARICOPA",9,25,"#f58181"
"MC0722",2879,2212,5091,"MARICOPA",6,23,"#f58181"
"MC0723",257,128,385,"MARICOPA",4,13,"#cc3333"
"MC0724",1605,1077,2682,"MARICOPA",5,12,"#f58181"
"MC0725",189,884,1073,"MARICOPA",7,24,"#000066"
"MC0726",147,142,289,"MARICOPA",9,23,"#ffd5d9"
"MC0727",1169,1197,2366,"MARICOPA",3,13,"#d5d9ff"
"MC0728",2718,913,3631,"MARICOPA",4,13,"#aa2222"
"MC0729",795,571,1366,"MARICOPA",5,16,"#f58181"
"MC0730",3339,2499,5838,"MARICOPA",8,13,"#f58181"
"MC0731",1146,964,2110,"MARICOPA",8,29,"#ffaaae"
"MC0732",651,531,1182,"MARICOPA",6,15,"#f58181"
"MC0733",1363,1434,2797,"MARICOPA",9,28,"#d5d9ff"
"MC0734",870,1011,1881,"MARICOPA",8,4,"#aaaeff"
"MC0735",1268,699,1967,"MARICOPA",5,16,"#eb4747"
"MC0736",827,817,1644,"MARICOPA",6,28,"#ffd5d9"
"MC0737",1513,1032,2545,"MARICOPA",8,22,"#f58181"
"MC0738",634,2088,2722,"MARICOPA",7,24,"#111188"
"MC0739",1999,2464,4463,"MARICOPA",9,18,"#8181f5"
"MC0740",1374,466,1840,"MARICOPA",4,13,"#aa2222"
"MC0741",2058,882,2940,"MARICOPA",8,1,"#cc3333"
"MC0742",929,845,1774,"MARICOPA",6,20,"#ffd5d9"
"MC0743",1069,1387,2456,"MARICOPA",9,18,"#8181f5"
"MC0744",501,1314,1815,"MARICOPA",9,24,"#2222aa"
"MC0745",966,822,1788,"MARICOPA",8,21,"#ffaaae"
"MC0746",776,983,1759,"MARICOPA",6,28,"#8181f5"
"MC0747",689,847,1536,"MARICOPA",9,23,"#8181f5"
"MC0748",2370,1127,3497,"MARICOPA",8,22,"#cc3333"
"MO0201",132,20,152,"MOHAVE",4,5,"#660000"
"MO0202",100,39,139,"MOHAVE",4,5,"#aa2222"
"MO0203",328,92,420,"MOHAVE",4,5,"#881111"
"MO0204",295,81,376,"MOHAVE",4,5,"#881111"
"MO0205",762,44,806,"MOHAVE",4,5,"#660000"
"MO0206",58,17,75,"MOHAVE",4,5,"#881111"
"MO0207",1049,328,1377,"MOHAVE",4,5,"#881111"
"MO0208",501,162,663,"MOHAVE",4,5,"#881111"
"MO0209",462,194,656,"MOHAVE",4,5,"#aa2222"
"MO0210",3017,942,3959,"MOHAVE",4,5,"#881111"
"MO0211",9133,3753,12886,"MOHAVE",4,5,"#aa2222"
"MO0212",5860,2120,7980,"MOHAVE",4,5,"#aa2222"
"MO0213",1046,313,1359,"MOHAVE",4,5,"#881111"
"MO0214",84,14,98,"MOHAVE",4,5,"#660000"
"MO0215",2260,951,3211,"MOHAVE",4,5,"#aa2222"
"MO0216",2881,1046,3927,"MOHAVE",4,5,"#aa2222"
"MO0217",4084,1442,5526,"MOHAVE",4,5,"#aa2222"
"MO0218",4443,1462,5905,"MOHAVE",4,5,"#881111"
"MO0219",5319,1481,6800,"MOHAVE",4,5,"#881111"
"MO0220",13570,4069,17639,"MOHAVE",4,5,"#881111"
"MO0221",598,270,868,"MOHAVE",4,5,"#cc3333"
"MO0222",603,207,810,"MOHAVE",4,5,"#aa2222"
"MO0223",46,24,70,"MOHAVE",1,7,"#cc3333"
"MO0224",51,143,194,"MOHAVE",1,7,"#2222aa"
"NA0001",1271,4300,5571,"NAVAJO",1,7,"#111188"
"NA0002",249,625,874,"NAVAJO",1,7,"#2222aa"
"NA0003",108,81,189,"NAVAJO",1,7,"#f58181"
"NA0004",1672,3069,4741,"NAVAJO",1,7,"#4747eb"
"NA0005",269,797,1066,"NAVAJO",1,7,"#2222aa"
"NA0006",76,351,427,"NAVAJO",1,7,"#000066"
"NA0007",4453,705,5158,"NAVAJO",1,6,"#660000"
"NA0008",1507,775,2282,"NAVAJO",1,6,"#cc3333"
"NA0009",778,265,1043,"NAVAJO",1,6,"#aa2222"
"NA0010",626,112,738,"NAVAJO",1,6,"#660000"
"NA0011",1744,513,2257,"NAVAJO",1,6,"#881111"
"NA0012",623,218,841,"NAVAJO",1,7,"#aa2222"
"NA0013",4744,1464,6208,"NAVAJO",1,7,"#881111"
"NA0014",3760,3349,7109,"NAVAJO",1,7,"#ffaaae"
"PM0001",491,490,981,"Pima",3,4,"#ffd5d9"
"PM0002",64,55,119,"Pima",3,4,"#ffaaae"
"PM0003",22,125,147,"Pima",3,4,"#000066"
"PM0004",119,516,635,"Pima",3,4,"#000066"
"PM0005",1691,747,2438,"Pima",3,11,"#cc3333"
"PM0006",1118,736,1854,"Pima",1,11,"#eb4747"
"PM0007",49,33,82,"Pima",3,2,"#f58181"
"PM0008",184,213,397,"Pima",3,2,"#aaaeff"
"PM0009",916,1125,2041,"Pima",2,10,"#8181f5"
"PM0010",976,809,1785,"Pima",2,2,"#ffaaae"
"PM0011",1562,558,2120,"Pima",2,14,"#aa2222"
"PM0012",2147,1792,3939,"Pima",1,11,"#ffaaae"
"PM0013",1017,1051,2068,"Pima",1,11,"#d5d9ff"
"PM0014",1357,1135,2492,"Pima",1,11,"#ffaaae"
"PM0015",569,434,1003,"Pima",2,9,"#f58181"
"PM0016",916,1717,2633,"Pima",3,3,"#3333cc"
"PM0017",292,1023,1315,"Pima",3,3,"#111188"
"PM0018",249,1206,1455,"Pima",3,3,"#000066"
"PM0019",201,137,338,"Pima",3,2,"#f58181"
"PM0020",370,1247,1617,"Pima",3,3,"#111188"
"PM0021",1220,1264,2484,"Pima",3,3,"#d5d9ff"
"PM0022",666,1308,1974,"Pima",3,3,"#3333cc"
"PM0023",657,1411,2068,"Pima",3,3,"#3333cc"
"PM0024",850,605,1455,"Pima",1,11,"#f58181"
"PM0025",292,1086,1378,"Pima",3,3,"#111188"
"PM0026",322,1172,1494,"Pima",3,3,"#111188"
"PM0027",0,0,0,"Pima",2,11,NA
"PM0028",183,669,852,"Pima",3,4,"#111188"
"PM0029",1447,1256,2703,"Pima",2,9,"#ffaaae"
"PM0030",1003,1331,2334,"Pima",2,9,"#8181f5"
"PM0031",628,591,1219,"Pima",2,9,"#ffd5d9"
"PM0032",1437,1600,3037,"Pima",2,9,"#aaaeff"
"PM0033",562,1022,1584,"Pima",3,3,"#4747eb"
"PM0034",397,489,886,"Pima",2,3,"#8181f5"
"PM0035",258,234,492,"Pima",1,11,"#ffd5d9"
"PM0036",793,1277,2070,"Pima",2,3,"#4747eb"
"PM0037",193,590,783,"Pima",3,3,"#111188"
"PM0038",491,863,1354,"Pima",2,9,"#4747eb"
"PM0039",1526,1116,2642,"Pima",2,10,"#f58181"
"PM0040",996,811,1807,"Pima",1,11,"#f58181"
"PM0041",1176,2007,3183,"Pima",3,3,"#4747eb"
"PM0042",379,1910,2289,"Pima",3,3,"#000066"
"PM0043",182,560,742,"Pima",3,3,"#111188"
"PM0044",202,1180,1382,"Pima",3,3,"#000066"
"PM0045",133,1108,1241,"Pima",3,3,"#000066"
"PM0046",526,298,824,"Pima",2,14,"#eb4747"
"PM0047",312,1178,1490,"Pima",3,2,"#111188"
"PM0048",372,771,1143,"Pima",3,2,"#3333cc"
"PM0049",580,401,981,"Pima",2,14,"#f58181"
"PM0050",246,970,1216,"Pima",3,2,"#111188"
"PM0051",187,720,907,"Pima",3,3,"#111188"
"PM0052",225,860,1085,"Pima",3,3,"#111188"
"PM0053",641,1780,2421,"Pima",3,2,"#2222aa"
"PM0054",948,1749,2697,"Pima",3,2,"#4747eb"
"PM0055",329,614,943,"Pima",2,9,"#3333cc"
"PM0056",700,1295,1995,"Pima",2,9,"#4747eb"
"PM0057",621,1620,2241,"Pima",2,9,"#2222aa"
"PM0058",422,1437,1859,"Pima",2,9,"#111188"
"PM0059",309,736,1045,"Pima",3,4,"#2222aa"
"PM0060",525,414,939,"Pima",3,4,"#f58181"
"PM0061",796,918,1714,"Pima",2,9,"#aaaeff"
"PM0062",194,1076,1270,"Pima",3,3,"#000066"
"PM0063",252,905,1157,"Pima",2,10,"#111188"
"PM0064",212,901,1113,"Pima",3,2,"#000066"
"PM0065",9,8,17,"Pima",2,14,"#ffaaae"
"PM0066",265,1016,1281,"Pima",3,2,"#111188"
"PM0067",512,1172,1684,"Pima",2,9,"#3333cc"
"PM0068",489,1357,1846,"Pima",2,9,"#2222aa"
"PM0069",1594,1735,3329,"Pima",2,10,"#d5d9ff"
"PM0070",855,657,1512,"Pima",3,11,"#f58181"
"PM0071",24,85,109,"Pima",3,4,"#111188"
"PM0072",667,1590,2257,"Pima",2,9,"#2222aa"
"PM0073",414,1736,2150,"Pima",2,9,"#000066"
"PM0074",1021,806,1827,"Pima",2,2,"#f58181"
"PM0075",481,1570,2051,"Pima",2,9,"#111188"
"PM0076",39,178,217,"Pima",3,4,"#000066"
"PM0077",1166,868,2034,"Pima",1,11,"#f58181"
"PM0078",260,1130,1390,"Pima",2,10,"#000066"
"PM0079",1331,983,2314,"Pima",2,11,"#f58181"
"PM0080",381,1268,1649,"Pima",2,10,"#111188"
"PM0081",480,369,849,"Pima",2,9,"#f58181"
"PM0082",339,1268,1607,"Pima",2,10,"#111188"
"PM0083",833,443,1276,"Pima",2,2,"#cc3333"
"PM0084",2482,1581,4063,"Pima",2,2,"#eb4747"
"PM0085",456,693,1149,"Pima",2,9,"#4747eb"
"PM0086",704,1723,2427,"Pima",2,2,"#2222aa"
"PM0087",149,300,449,"Pima",2,9,"#3333cc"
"PM0088",1028,1242,2270,"Pima",2,9,"#aaaeff"
"PM0089",742,1427,2169,"Pima",2,9,"#3333cc"
"PM0090",622,459,1081,"Pima",2,14,"#f58181"
"PM0091",617,1327,1944,"Pima",2,9,"#3333cc"
"PM0092",1095,1350,2445,"Pima",3,3,"#8181f5"
"PM0093",417,1137,1554,"Pima",2,10,"#2222aa"
"PM0094",460,1276,1736,"Pima",2,10,"#2222aa"
"PM0095",574,347,921,"Pima",2,14,"#eb4747"
"PM0096",533,1344,1877,"Pima",2,10,"#2222aa"
"PM0097",376,950,1326,"Pima",3,3,"#2222aa"
"PM0098",572,1191,1763,"Pima",2,10,"#3333cc"
"PM0099",622,1231,1853,"Pima",2,9,"#3333cc"
"PM0100",695,1144,1839,"Pima",2,9,"#4747eb"
"PM0101",675,636,1311,"Pima",3,3,"#ffd5d9"
"PM0102",509,910,1419,"Pima",3,3,"#4747eb"
"PM0103",296,662,958,"Pima",2,10,"#3333cc"
"PM0104",1488,1243,2731,"Pima",1,11,"#ffaaae"
"PM0105",423,583,1006,"Pima",2,10,"#8181f5"
"PM0106",622,591,1213,"Pima",2,9,"#ffd5d9"
"PM0107",817,1380,2197,"Pima",2,10,"#4747eb"
"PM0108",1044,1861,2905,"Pima",2,10,"#4747eb"
"PM0109",2042,1290,3332,"Pima",2,14,"#eb4747"
"PM0110",105,700,805,"Pima",3,3,"#000066"
"PM0111",634,935,1569,"Pima",2,10,"#8181f5"
"PM0112",1152,1241,2393,"Pima",2,9,"#d5d9ff"
"PM0113",771,990,1761,"Pima",2,10,"#8181f5"
"PM0114",177,170,347,"Pima",2,2,"#ffd5d9"
"PM0115",1788,1401,3189,"Pima",1,11,"#f58181"
"PM0116",1328,1416,2744,"Pima",2,10,"#d5d9ff"
"PM0117",766,998,1764,"Pima",2,10,"#8181f5"
"PM0118",1006,1295,2301,"Pima",2,10,"#8181f5"
"PM0119",653,826,1479,"Pima",2,10,"#8181f5"
"PM0120",906,1136,2042,"Pima",2,10,"#8181f5"
"PM0121",751,728,1479,"Pima",2,10,"#ffd5d9"
"PM0122",657,698,1355,"Pima",2,10,"#d5d9ff"
"PM0123",1190,1344,2534,"Pima",2,10,"#aaaeff"
"PM0124",518,523,1041,"Pima",2,10,"#d5d9ff"
"PM0125",776,811,1587,"Pima",2,9,"#d5d9ff"
"PM0126",703,521,1224,"Pima",2,10,"#f58181"
"PM0127",3428,2205,5633,"Pima",1,11,"#eb4747"
"PM0128",838,891,1729,"Pima",2,10,"#d5d9ff"
"PM0129",661,790,1451,"Pima",2,10,"#aaaeff"
"PM0130",1205,1172,2377,"Pima",2,10,"#ffd5d9"
"PM0131",856,771,1627,"Pima",2,10,"#ffaaae"
"PM0132",1097,1044,2141,"Pima",2,10,"#ffd5d9"
"PM0133",1162,1103,2265,"Pima",2,10,"#ffd5d9"
"PM0134",765,690,1455,"Pima",2,9,"#ffaaae"
"PM0135",12,113,125,"Pima",3,4,"#000066"
"PM0136",7,64,71,"Pima",3,4,"#000066"
"PM0137",10,74,84,"Pima",3,4,"#000066"
"PM0138",38,259,297,"Pima",3,4,"#000066"
"PM0139",124,185,309,"Pima",3,2,"#8181f5"
"PM0140",289,195,484,"Pima",2,14,"#f58181"
"PM0141",2047,1719,3766,"Pima",2,2,"#ffaaae"
"PM0142",1239,1079,2318,"Pima",2,9,"#ffaaae"
"PM0143",60,599,659,"Pima",3,3,"#000066"
"PM0144",517,1222,1739,"Pima",3,3,"#2222aa"
"PM0145",2489,1950,4439,"Pima",1,11,"#f58181"
"PM0146",867,974,1841,"Pima",2,9,"#aaaeff"
"PM0147",865,688,1553,"Pima",2,2,"#f58181"
"PM0148",831,858,1689,"Pima",2,9,"#d5d9ff"
"PM0149",718,892,1610,"Pima",2,9,"#8181f5"
"PM0150",182,216,398,"Pima",1,9,"#aaaeff"
"PM0151",299,437,736,"Pima",3,11,"#8181f5"
"PM0152",148,402,550,"Pima",3,4,"#2222aa"
"PM0153",839,1529,2368,"Pima",2,3,"#4747eb"
"PM0154",265,622,887,"Pima",2,3,"#2222aa"
"PM0155",213,472,685,"Pima",3,2,"#3333cc"
"PM0156",677,657,1334,"Pima",2,10,"#ffd5d9"
"PM0157",407,1127,1534,"Pima",3,3,"#2222aa"
"PM0158",662,902,1564,"Pima",2,9,"#8181f5"
"PM0159",482,1453,1935,"Pima",3,2,"#111188"
"PM0160",155,630,785,"Pima",3,3,"#000066"
"PM0161",430,258,688,"Pima",3,11,"#eb4747"
"PM0162",545,760,1305,"Pima",2,9,"#8181f5"
"PM0163",844,914,1758,"Pima",2,9,"#d5d9ff"
"PM0164",453,1385,1838,"Pima",2,9,"#111188"
"PM0165",181,75,256,"Pima",2,14,"#aa2222"
"PM0166",389,1464,1853,"Pima",2,3,"#111188"
"PM0167",270,997,1267,"Pima",2,9,"#111188"
"PM0168",446,281,727,"Pima",3,2,"#eb4747"
"PM0169",1752,1283,3035,"Pima",1,11,"#f58181"
"PM0170",714,1132,1846,"Pima",2,9,"#4747eb"
"PM0171",1200,1130,2330,"Pima",2,9,"#ffd5d9"
"PM0172",1601,1132,2733,"Pima",1,11,"#f58181"
"PM0173",1256,973,2229,"Pima",1,11,"#f58181"
"PM0174",1051,1265,2316,"Pima",2,10,"#aaaeff"
"PM0175",1053,639,1692,"Pima",1,11,"#eb4747"
"PM0176",744,538,1282,"Pima",2,14,"#f58181"
"PM0177",1216,1142,2358,"Pima",2,10,"#ffd5d9"
"PM0178",1107,935,2042,"Pima",2,10,"#ffaaae"
"PM0179",1727,1261,2988,"Pima",2,10,"#f58181"
"PM0180",1219,1188,2407,"Pima",2,10,"#ffd5d9"
"PM0181",1446,1208,2654,"Pima",2,10,"#ffaaae"
"PM0182",1336,1214,2550,"Pima",2,10,"#ffd5d9"
"PM0183",947,821,1768,"Pima",2,10,"#ffaaae"
"PM0184",1495,807,2302,"Pima",1,11,"#eb4747"
"PM0185",663,596,1259,"Pima",2,9,"#ffaaae"
"PM0186",134,114,248,"Pima",2,11,"#ffaaae"
"PM0187",1471,1232,2703,"Pima",2,9,"#ffaaae"
"PM0188",1253,785,2038,"Pima",1,11,"#eb4747"
"PM0189",382,729,1111,"Pima",2,10,"#3333cc"
"PM0190",263,651,914,"Pima",3,4,"#2222aa"
"PM0191",420,380,800,"Pima",2,9,"#ffaaae"
"PM0192",1165,1084,2249,"Pima",2,10,"#ffd5d9"
"PM0193",803,621,1424,"Pima",2,2,"#f58181"
"PM0194",1603,1107,2710,"Pima",1,11,"#f58181"
"PM0195",936,576,1512,"Pima",2,14,"#eb4747"
"PM0196",2,5,7,"Pima",3,2,"#2222aa"
"PM0197",884,692,1576,"Pima",2,10,"#f58181"
"PM0198",1036,509,1545,"Pima",2,14,"#cc3333"
"PM0199",1317,892,2209,"Pima",2,10,"#f58181"
"PM0200",735,413,1148,"Pima",1,11,"#eb4747"
"PM0201",940,1014,1954,"Pima",2,9,"#d5d9ff"
"PM0202",1343,1138,2481,"Pima",2,9,"#ffaaae"
"PM0203",390,543,933,"Pima",3,3,"#8181f5"
"PM0204",293,56,349,"Pima",3,2,"#660000"
"PM0205",1517,1000,2517,"Pima",2,2,"#eb4747"
"PM0206",215,128,343,"Pima",2,14,"#eb4747"
"PM0207",1289,1214,2503,"Pima",2,2,"#ffd5d9"
"PM0208",552,424,976,"Pima",3,4,"#f58181"
"PM0209",1417,963,2380,"Pima",2,2,"#f58181"
"PM0210",708,1227,1935,"Pima",2,9,"#4747eb"
"PM0211",889,953,1842,"Pima",2,9,"#d5d9ff"
"PM0212",671,543,1214,"Pima",1,11,"#f58181"
"PM0213",122,123,245,"Pima",1,9,"#d5d9ff"
"PM0214",1001,1197,2198,"Pima",2,9,"#aaaeff"
"PM0215",587,388,975,"Pima",3,11,"#eb4747"
"PM0216",1073,818,1891,"Pima",1,11,"#f58181"
"PM0217",1576,1180,2756,"Pima",2,2,"#f58181"
"PM0218",1573,1600,3173,"Pima",2,10,"#d5d9ff"
"PM0219",915,808,1723,"Pima",2,9,"#ffaaae"
"PM0220",1477,1165,2642,"Pima",2,10,"#f58181"
"PM0221",1083,453,1536,"Pima",2,14,"#aa2222"
"PM0222",775,434,1209,"Pima",3,11,"#eb4747"
"PM0223",475,400,875,"Pima",1,11,"#ffaaae"
"PM0224",1520,1181,2701,"Pima",2,14,"#f58181"
"PM0225",1484,1497,2981,"Pima",2,9,"#d5d9ff"
"PM0226",419,364,783,"Pima",2,9,"#ffaaae"
"PM0227",1861,1511,3372,"Pima",2,2,"#f58181"
"PM0228",485,526,1011,"Pima",3,11,"#d5d9ff"
"PM0229",1950,1009,2959,"Pima",2,14,"#cc3333"
"PM0230",346,486,832,"Pima",2,9,"#8181f5"
"PM0231",1298,1177,2475,"Pima",2,2,"#ffd5d9"
"PM0232",395,518,913,"Pima",2,2,"#8181f5"
"PM0233",1005,1321,2326,"Pima",3,3,"#8181f5"
"PM0234",582,802,1384,"Pima",3,3,"#8181f5"
"PM0235",414,947,1361,"Pima",3,3,"#3333cc"
"PM0236",145,373,518,"Pima",3,4,"#2222aa"
"PM0237",556,842,1398,"Pima",2,9,"#4747eb"
"PM0238",938,1263,2201,"Pima",2,9,"#8181f5"
"PM0239",1303,1760,3063,"Pima",2,9,"#8181f5"
"PM0240",79,35,114,"Pima",2,14,"#cc3333"
"PM0241",798,835,1633,"Pima",2,9,"#d5d9ff"
"PM0242",931,764,1695,"Pima",1,11,"#ffaaae"
"PM0243",954,600,1554,"Pima",2,10,"#eb4747"
"PM0244",76,313,389,"Pima",3,2,"#000066"
"PM0245",216,917,1133,"Pima",3,3,"#000066"
"PM0246",154,1097,1251,"Pima",3,3,"#000066"
"PM0247",40,185,225,"Pima",3,3,"#000066"
"PM0248",98,306,404,"Pima",3,3,"#111188"
"PM0249",949,570,1519,"Pima",2,14,"#eb4747"
"PN0001",469,404,873,"PINAL",1,8,"#ffaaae"
"PN0004",156,212,368,"PINAL",1,8,"#8181f5"
"PN0005",658,562,1220,"PINAL",1,8,"#ffaaae"
"PN0006",190,377,567,"PINAL",1,8,"#3333cc"
"PN0007",1136,816,1952,"PINAL",1,8,"#f58181"
"PN0008",1565,1011,2576,"PINAL",1,11,"#eb4747"
"PN0009",791,449,1240,"PINAL",1,11,"#eb4747"
"PN0010",902,464,1366,"PINAL",1,11,"#cc3333"
"PN0011",117,59,176,"PINAL",1,8,"#cc3333"
"PN0012",130,328,458,"PINAL",1,8,"#2222aa"
"PN0013",1053,678,1731,"PINAL",1,8,"#eb4747"
"PN0014",161,355,516,"PINAL",1,8,"#3333cc"
"PN0015",1601,906,2507,"PINAL",1,11,"#eb4747"
"PN0016",854,377,1231,"PINAL",1,11,"#cc3333"
"PN0017",326,287,613,"PINAL",1,8,"#ffaaae"
"PN0018",915,694,1609,"PINAL",1,8,"#f58181"
"PN0019",431,389,820,"PINAL",1,8,"#ffaaae"
"PN0020",339,161,500,"PINAL",1,8,"#cc3333"
"PN0021",403,213,616,"PINAL",1,8,"#cc3333"
"PN0022",320,130,450,"PINAL",1,8,"#aa2222"
"PN0023",722,441,1163,"PINAL",4,8,"#eb4747"
"PN0024",519,376,895,"PINAL",4,8,"#f58181"
"PN0025",699,236,935,"PINAL",1,8,"#aa2222"
"PN0026",1338,742,2080,"PINAL",4,8,"#eb4747"
"PN0027",2505,1470,3975,"PINAL",4,8,"#eb4747"
"PN0028",1791,994,2785,"PINAL",4,16,"#eb4747"
"PN0029",85,245,330,"PINAL",1,8,"#2222aa"
"PN0030",905,811,1716,"PINAL",1,11,"#ffaaae"
"PN0031",155,95,250,"PINAL",1,11,"#eb4747"
"PN0032",530,518,1048,"PINAL",1,8,"#ffd5d9"
"PN0033",570,467,1037,"PINAL",1,8,"#ffaaae"
"PN0034",612,545,1157,"PINAL",1,8,"#ffaaae"
"PN0035",678,548,1226,"PINAL",1,8,"#f58181"
"PN0036",361,501,862,"PINAL",1,8,"#8181f5"
"PN0037",1117,756,1873,"PINAL",1,11,"#f58181"
"PN0038",404,293,697,"PINAL",1,11,"#f58181"
"PN0039",953,621,1574,"PINAL",1,11,"#eb4747"
"PN0040",998,704,1702,"PINAL",4,16,"#f58181"
"PN0041",1083,615,1698,"PINAL",1,8,"#eb4747"
"PN0042",575,358,933,"PINAL",4,16,"#eb4747"
"PN0043",1040,607,1647,"PINAL",4,16,"#eb4747"
"PN0044",1026,575,1601,"PINAL",4,16,"#eb4747"
"PN0045",976,439,1415,"PINAL",4,16,"#cc3333"
"PN0046",962,461,1423,"PINAL",4,16,"#cc3333"
"PN0047",694,490,1184,"PINAL",4,16,"#f58181"
"PN0048",1026,606,1632,"PINAL",4,16,"#eb4747"
"PN0049",299,115,414,"PINAL",4,8,"#aa2222"
"PN0050",337,621,958,"PINAL",1,8,"#4747eb"
"PN0051",21,7,28,"PINAL",4,8,"#881111"
"PN0052",60,26,86,"PINAL",4,8,"#cc3333"
"PN0053",14,98,112,"PINAL",3,4,"#000066"
"PN0054",686,326,1012,"PINAL",1,11,"#cc3333"
"PN0055",788,550,1338,"PINAL",1,11,"#f58181"
"PN0056",789,432,1221,"PINAL",4,16,"#eb4747"
"PN0057",1165,591,1756,"PINAL",4,16,"#cc3333"
"PN0058",713,347,1060,"PINAL",4,16,"#cc3333"
"PN0059",1109,613,1722,"PINAL",4,16,"#eb4747"
"PN0060",67,219,286,"PINAL",1,8,"#111188"
"PN0061",74,175,249,"PINAL",1,8,"#2222aa"
"PN0062",62,229,291,"PINAL",1,8,"#111188"
"PN0063",516,304,820,"PINAL",4,16,"#eb4747"
"PN0064",1446,725,2171,"PINAL",4,16,"#cc3333"
"PN0066",920,471,1391,"PINAL",4,16,"#cc3333"
"PN0067",495,269,764,"PINAL",1,11,"#eb4747"
"PN0068",951,651,1602,"PINAL",4,8,"#f58181"
"PN0069",560,375,935,"PINAL",4,8,"#f58181"
"PN0070",843,499,1342,"PINAL",4,8,"#eb4747"
"PN0071",874,419,1293,"PINAL",4,16,"#cc3333"
"PN0072",491,269,760,"PINAL",4,8,"#eb4747"
"PN0073",541,437,978,"PINAL",1,11,"#f58181"
"PN0074",781,730,1511,"PINAL",1,11,"#ffd5d9"
"PN0075",949,608,1557,"PINAL",4,8,"#eb4747"
"PN0076",937,473,1410,"PINAL",4,16,"#cc3333"
"PN0077",49,145,194,"PINAL",1,11,"#2222aa"
"PN0078",872,658,1530,"PINAL",1,11,"#f58181"
"PN0079",951,798,1749,"PINAL",1,11,"#ffaaae"
"PN0080",2013,1508,3521,"PINAL",1,11,"#f58181"
"PN0081",994,705,1699,"PINAL",1,8,"#f58181"
"PN0082",169,232,401,"PINAL",1,8,"#8181f5"
"PN0083",1155,769,1924,"PINAL",1,8,"#eb4747"
"PN0084",560,311,871,"PINAL",4,16,"#eb4747"
"PN0085",906,555,1461,"PINAL",4,8,"#eb4747"
"PN0086",1269,863,2132,"PINAL",4,8,"#f58181"
"PN0087",702,541,1243,"PINAL",4,8,"#f58181"
"PN0088",2596,1161,3757,"PINAL",4,16,"#cc3333"
"PN0089",1156,583,1739,"PINAL",4,8,"#cc3333"
"PN0090",606,616,1222,"PINAL",1,11,"#d5d9ff"
"PN0091",614,287,901,"PINAL",1,11,"#cc3333"
"PN0092",1879,1251,3130,"PINAL",1,11,"#eb4747"
"PN0093",469,504,973,"PINAL",1,8,"#d5d9ff"
"PN0094",827,544,1371,"PINAL",4,8,"#eb4747"
"PN0095",786,455,1241,"PINAL",4,8,"#eb4747"
"PN0096",728,335,1063,"PINAL",4,12,"#cc3333"
"PN0097",756,523,1279,"PINAL",4,8,"#f58181"
"PN0098",675,406,1081,"PINAL",4,16,"#eb4747"
"PN0099",889,606,1495,"PINAL",1,8,"#f58181"
"PN0100",620,594,1214,"PINAL",1,11,"#ffd5d9"
"PN0101",629,658,1287,"PINAL",1,11,"#d5d9ff"
"PN0102",946,741,1687,"PINAL",1,11,"#f58181"
"PN0103",0,0,0,"PINAL",1,7,NA
"PN0104",95,52,147,"PINAL",1,11,"#eb4747"
"PN0105",32,29,61,"PINAL",1,11,"#ffd5d9"
"SC0001",57,201,258,"SANTA_CRUZ",3,2,"#111188"
"SC0002",134,444,578,"SANTA_CRUZ",3,2,"#111188"
"SC0003",85,302,387,"SANTA_CRUZ",3,2,"#111188"
"SC0004",49,148,197,"SANTA_CRUZ",3,2,"#111188"
"SC0005",197,454,651,"SANTA_CRUZ",3,2,"#3333cc"
"SC0006",333,172,505,"SANTA_CRUZ",3,2,"#cc3333"
"SC0007",770,1074,1844,"SANTA_CRUZ",3,2,"#8181f5"
"SC0008",203,794,997,"SANTA_CRUZ",3,2,"#111188"
"SC0009",76,118,194,"SANTA_CRUZ",3,2,"#4747eb"
"SC0010",118,316,434,"SANTA_CRUZ",3,2,"#2222aa"
"SC0011",585,755,1340,"SANTA_CRUZ",3,2,"#8181f5"
"SC0012",52,230,282,"SANTA_CRUZ",3,2,"#000066"
"SC0013",81,144,225,"SANTA_CRUZ",3,2,"#4747eb"
"SC0014",233,413,646,"SANTA_CRUZ",3,2,"#4747eb"
"SC0015",451,261,712,"SANTA_CRUZ",3,2,"#eb4747"
"SC0016",62,135,197,"SANTA_CRUZ",3,2,"#3333cc"
"SC0017",411,1006,1417,"SANTA_CRUZ",3,2,"#2222aa"
"SC0018",116,263,379,"SANTA_CRUZ",3,2,"#3333cc"
"SC0019",281,734,1015,"SANTA_CRUZ",3,2,"#2222aa"
"SC0020",119,410,529,"SANTA_CRUZ",3,2,"#111188"
"SC0021",251,621,872,"SANTA_CRUZ",3,2,"#2222aa"
"SC0022",53,172,225,"SANTA_CRUZ",3,2,"#111188"
"SC0023",24,19,43,"SANTA_CRUZ",3,2,"#f58181"
"SCNA",51,55,106,NA,NA,NA,"#d5d9ff"
"YA0201",4474,2554,7028,"YAVAPAI",4,1,"#eb4747"
"YA0202",2705,2172,4877,"YAVAPAI",4,1,"#f58181"
"YA0203",2147,1561,3708,"YAVAPAI",4,1,"#f58181"
"YA0204",3220,2372,5592,"YAVAPAI",4,1,"#f58181"
"YA0205",388,109,497,"YAVAPAI",4,1,"#881111"
"YA0206",57,5,62,"YAVAPAI",4,1,"#660000"
"YA0207",829,253,1082,"YAVAPAI",4,1,"#881111"
"YA0208",427,201,628,"YAVAPAI",4,1,"#cc3333"
"YA0209",402,122,524,"YAVAPAI",4,1,"#881111"
"YA0210",36,19,55,"YAVAPAI",4,1,"#cc3333"
"YA0211",23,7,30,"YAVAPAI",4,1,"#881111"
"YA0212",0,0,0,"YAVAPAI",4,1,NA
"YA0213",231,80,311,"YAVAPAI",4,1,"#aa2222"
"YA0214",363,133,496,"YAVAPAI",4,1,"#aa2222"
"YA0215",2614,1066,3680,"YAVAPAI",4,1,"#aa2222"
"YA0216",1129,837,1966,"YAVAPAI",4,6,"#f58181"
"YA0217",48,35,83,"YAVAPAI",1,6,"#f58181"
"YA0218",1300,779,2079,"YAVAPAI",1,6,"#eb4747"
"YA0219",3202,1378,4580,"YAVAPAI",1,6,"#cc3333"
"YA0220",16,10,26,"YAVAPAI",1,1,"#eb4747"
"YA0221",213,89,302,"YAVAPAI",4,1,"#aa2222"
"YA0222",1703,700,2403,"YAVAPAI",4,1,"#aa2222"
"YA0223",950,325,1275,"YAVAPAI",4,1,"#aa2222"
"YA0224",67,16,83,"YAVAPAI",4,1,"#660000"
"YA0225",3675,1313,4988,"YAVAPAI",4,1,"#aa2222"
"YA0226",26,19,45,"YAVAPAI",4,1,"#f58181"
"YA0227",1850,2878,4728,"YAVAPAI",1,6,"#4747eb"
"YA0228",1961,2370,4331,"YAVAPAI",1,6,"#aaaeff"
"YA0229",3420,2410,5830,"YAVAPAI",4,6,"#f58181"
"YA0230",2875,2196,5071,"YAVAPAI",4,6,"#f58181"
"YA0231",224,85,309,"YAVAPAI",4,1,"#aa2222"
"YA0232",924,1060,1984,"YAVAPAI",4,6,"#aaaeff"
"YA0233",21,29,50,"YAVAPAI",1,6,"#8181f5"
"YA0234",4844,2412,7256,"YAVAPAI",4,1,"#cc3333"
"YA0235",2845,932,3777,"YAVAPAI",4,1,"#881111"
"YA0236",363,118,481,"YAVAPAI",4,1,"#881111"
"YA0237",3554,1030,4584,"YAVAPAI",4,1,"#881111"
"YA0238",4250,1274,5524,"YAVAPAI",4,1,"#881111"
"YA0239",1720,375,2095,"YAVAPAI",4,1,"#660000"
"YA0240",458,151,609,"YAVAPAI",4,1,"#881111"
"YA0241",318,112,430,"YAVAPAI",4,1,"#aa2222"
"YA0242",3063,1452,4515,"YAVAPAI",4,1,"#cc3333"
"YA0243",4186,1789,5975,"YAVAPAI",4,1,"#aa2222"
"YA0244",4636,2163,6799,"YAVAPAI",4,1,"#cc3333"
"YA0245",2391,1169,3560,"YAVAPAI",4,1,"#cc3333"
"YU0001",164,302,466,"YUMA",3,4,"#4747eb"
"YU0002",232,332,564,"YUMA",3,4,"#8181f5"
"YU0003",224,290,514,"YUMA",3,4,"#8181f5"
"YU0004",716,967,1683,"YUMA",3,4,"#8181f5"
"YU0005",808,422,1230,"YUMA",3,13,"#cc3333"
"YU0006",301,679,980,"YUMA",3,4,"#3333cc"
"YU0007",210,1063,1273,"YUMA",3,4,"#000066"
"YU0008",568,241,809,"YUMA",4,13,"#aa2222"
"YU0009",909,257,1166,"YUMA",4,13,"#881111"
"YU0010",1490,731,2221,"YUMA",4,13,"#cc3333"
"YU0011",767,441,1208,"YUMA",4,13,"#eb4747"
"YU0012",913,337,1250,"YUMA",4,13,"#aa2222"
"YU0013",348,400,748,"YUMA",3,4,"#aaaeff"
"YU0014",163,113,276,"YUMA",3,13,"#f58181"
"YU0015",831,540,1371,"YUMA",4,13,"#eb4747"
"YU0016",536,434,970,"YUMA",3,13,"#f58181"
"YU0017",1275,568,1843,"YUMA",4,13,"#cc3333"
"YU0018",108,22,130,"YUMA",4,13,"#660000"
"YU0019",48,32,80,"YUMA",4,13,"#f58181"
"YU0020",983,398,1381,"YUMA",4,13,"#aa2222"
"YU0021",15,4,19,"YUMA",3,4,"#881111"
"YU0022",990,476,1466,"YUMA",4,13,"#cc3333"
"YU0023",1002,410,1412,"YUMA",4,13,"#aa2222"
"YU0024",2709,888,3597,"YUMA",4,13,"#881111"
"YU0025",1461,502,1963,"YUMA",4,13,"#aa2222"
"YU0026",98,170,268,"YUMA",3,4,"#4747eb"
"YU0027",275,211,486,"YUMA",3,4,"#f58181"
"YU0028",113,191,304,"YUMA",3,4,"#4747eb"
"YU0029",105,1146,1251,"YUMA",3,4,"#000066"
"YU0030",103,1082,1185,"YUMA",3,4,"#000066"
"YU0031",184,1371,1555,"YUMA",3,4,"#000066"
"YU0032",209,356,565,"YUMA",3,4,"#4747eb"
"YU0033",203,135,338,"YUMA",3,13,"#eb4747"
"YU0034",314,102,416,"YUMA",4,13,"#881111"
"YU0035",561,414,975,"YUMA",3,4,"#f58181"
"YU0036",610,557,1167,"YUMA",3,4,"#ffd5d9"
"YU0037",340,532,872,"YUMA",3,4,"#4747eb"
"YU0038",500,517,1017,"YUMA",3,4,"#d5d9ff"
"YU0039",630,472,1102,"YUMA",3,4,"#f58181"
"YU0040",607,516,1123,"YUMA",3,4,"#ffaaae"
"YU0041",704,552,1256,"YUMA",3,4,"#f58181"
"YU0042",619,697,1316,"YUMA",3,13,"#aaaeff"
"YU0043",12,10,22,"YUMA",3,13,"#ffaaae"
"YU0044",0,0,0,"YUMA",3,4,NA
