"contestLongName","Pctcd","Ducey, Doug","Garcia, David","Torres, Angel","total","color"
"Governor","AP0002",231,55,3,286,"#660000"
"Governor","AP0003",253,1251,75,1504,"#000066"
"Governor","AP0005",121,591,39,712,"#000066"
"Governor","AP0009",1103,210,24,1313,"#660000"
"Governor","AP0010",67,292,5,359,"#000066"
"Governor","AP0011",133,502,26,635,"#111188"
"Governor","AP0012",555,71,8,626,"#660000"
"Governor","AP0013",105,351,28,456,"#111188"
"Governor","AP0016",725,114,9,839,"#660000"
"Governor","AP0017",533,62,8,595,"#660000"
"Governor","AP0019",377,1128,76,1505,"#2222aa"
"Governor","AP0022",59,273,12,332,"#000066"
"Governor","AP0023",89,415,21,504,"#000066"
"Governor","AP0025",94,33,3,127,"#aa2222"
"Governor","AP0027",154,352,27,506,"#3333cc"
"Governor","AP0029",77,464,22,541,"#000066"
"Governor","AP0031",87,316,17,403,"#111188"
"Governor","AP0033",89,628,41,717,"#000066"
"Governor","AP0035",65,238,13,303,"#111188"
"Governor","AP0037",19,51,2,70,"#2222aa"
"Governor","AP0039",76,598,31,674,"#000066"
"Governor","AP0041",9,53,4,62,"#000066"
"Governor","AP0043",74,375,11,449,"#000066"
"Governor","AP0045",205,50,6,255,"#660000"
"Governor","AP0046",52,187,9,239,"#111188"
"Governor","AP0048",282,432,27,714,"#4747eb"
"Governor","AP0051",20,75,2,95,"#111188"
"Governor","AP0052",71,231,24,302,"#111188"
"Governor","AP0054",85,514,24,599,"#000066"
"Governor","AP0056",50,313,19,363,"#000066"
"Governor","AP0058",49,377,18,426,"#000066"
"Governor","AP0059",437,52,13,489,"#660000"
"Governor","AP0061",660,159,23,819,"#660000"
"Governor","AP0065",176,817,48,993,"#000066"
"Governor","AP0067",54,322,17,376,"#000066"
"Governor","AP0070",518,121,13,639,"#660000"
"Governor","AP0074",80,503,20,583,"#000066"
"Governor","AP0076",49,245,13,294,"#000066"
"Governor","AP0078",49,183,14,232,"#111188"
"Governor","AP0080",53,264,11,317,"#000066"
"Governor","AP0082",866,135,19,1001,"#660000"
"Governor","AP0084",66,658,29,724,"#000066"
"Governor","AP0086",74,277,18,351,"#111188"
"Governor","AP0088",184,617,40,801,"#111188"
"Governor","CH0001",721,260,41,981,"#aa2222"
"Governor","CH0002",996,268,36,1264,"#881111"
"Governor","CH0003",807,299,28,1106,"#aa2222"
"Governor","CH0004",194,719,25,913,"#111188"
"Governor","CH0005",416,435,30,851,"#d5d9ff"
"Governor","CH0006",368,561,40,929,"#4747eb"
"Governor","CH0007",122,41,6,163,"#aa2222"
"Governor","CH0008",881,252,31,1133,"#881111"
"Governor","CH0009",177,479,16,656,"#2222aa"
"Governor","CH0010",366,650,22,1016,"#4747eb"
"Governor","CH0011",145,610,26,755,"#000066"
"Governor","CH0012",141,417,20,558,"#2222aa"
"Governor","CH0013",289,397,18,686,"#8181f5"
"Governor","CH0014",924,234,40,1158,"#881111"
"Governor","CH0015",993,337,20,1330,"#aa2222"
"Governor","CH0016",382,170,24,552,"#cc3333"
"Governor","CH0017",453,155,15,608,"#aa2222"
"Governor","CH0018",115,192,11,307,"#4747eb"
"Governor","CH0019",614,195,30,809,"#881111"
"Governor","CH0020",241,348,18,589,"#8181f5"
"Governor","CH0021",533,191,13,724,"#aa2222"
"Governor","CH0022",135,94,5,229,"#f58181"
"Governor","CH0023",125,23,3,148,"#660000"
"Governor","CH0024",1055,226,23,1281,"#660000"
"Governor","CH0025",231,86,11,317,"#aa2222"
"Governor","CH0026",926,414,21,1340,"#cc3333"
"Governor","CH0027",1266,553,41,1819,"#cc3333"
"Governor","CH0028",581,309,38,890,"#cc3333"
"Governor","CH0029",436,225,18,661,"#cc3333"
"Governor","CH0030",337,173,23,510,"#cc3333"
"Governor","CH0031",703,333,27,1036,"#cc3333"
"Governor","CH0032",1293,409,29,1702,"#881111"
"Governor","CH0033",790,306,27,1096,"#aa2222"
"Governor","CH0034",601,285,34,886,"#cc3333"
"Governor","CH0035",948,260,26,1208,"#881111"
"Governor","CH0036",565,281,21,846,"#cc3333"
"Governor","CH0037",792,247,29,1039,"#881111"
"Governor","CH0038",466,232,25,698,"#cc3333"
"Governor","CH0039",649,427,40,1076,"#eb4747"
"Governor","CH0040",980,330,25,1310,"#aa2222"
"Governor","CH0041",1092,446,40,1538,"#aa2222"
"Governor","CH0042",639,281,31,920,"#cc3333"
"Governor","CH0043",1248,400,19,1648,"#881111"
"Governor","CH0044",862,211,37,1073,"#660000"
"Governor","CH0045",271,98,13,369,"#aa2222"
"Governor","CH0046",1078,283,44,1361,"#881111"
"Governor","CH0047",672,174,19,846,"#881111"
"Governor","CH0048",614,128,6,742,"#660000"
"Governor","CH0049",405,132,16,537,"#881111"
"Governor","CN0001",257,893,24,1150,"#111188"
"Governor","CN0002",211,839,26,1050,"#111188"
"Governor","CN0003",106,698,13,804,"#000066"
"Governor","CN0004",404,928,19,1332,"#3333cc"
"Governor","CN0005",604,1058,32,1662,"#4747eb"
"Governor","CN0006",437,649,26,1086,"#8181f5"
"Governor","CN0007",378,606,12,984,"#4747eb"
"Governor","CN0008",217,481,13,698,"#3333cc"
"Governor","CN0009",255,664,34,919,"#2222aa"
"Governor","CN0010",51,253,12,304,"#000066"
"Governor","CN0011",181,383,17,564,"#3333cc"
"Governor","CN0012",113,590,25,703,"#000066"
"Governor","CN0013",68,326,7,394,"#000066"
"Governor","CN0014",165,632,23,797,"#111188"
"Governor","CN0015",512,1178,73,1690,"#3333cc"
"Governor","CN0016",497,901,38,1398,"#4747eb"
"Governor","CN0017",173,245,10,418,"#8181f5"
"Governor","CN0018",224,281,21,505,"#8181f5"
"Governor","CN0019",553,735,28,1288,"#8181f5"
"Governor","CN0020",90,384,12,474,"#000066"
"Governor","CN0021",672,1029,38,1701,"#4747eb"
"Governor","CN0022",889,1175,42,2064,"#8181f5"
"Governor","CN0023",349,606,40,955,"#4747eb"
"Governor","CN0024",925,1003,33,1928,"#d5d9ff"
"Governor","CN0025",546,795,30,1341,"#8181f5"
"Governor","CN0026",306,304,26,610,"#ffd5d9"
"Governor","CN0040",214,145,13,359,"#f58181"
"Governor","CN0041",363,88,3,451,"#660000"
"Governor","CN0042",193,357,28,550,"#4747eb"
"Governor","CN0043",175,399,19,574,"#3333cc"
"Governor","CN0047",86,226,11,312,"#2222aa"
"Governor","CN0048",32,141,5,173,"#000066"
"Governor","CN0050",845,542,30,1387,"#eb4747"
"Governor","CN0051",29,21,2,50,"#f58181"
"Governor","CN0052",818,524,22,1342,"#eb4747"
"Governor","CN0053",109,25,2,134,"#660000"
"Governor","CN0055",125,153,3,278,"#8181f5"
"Governor","CN0056",273,271,6,544,"#ffd5d9"
"Governor","CN0058",345,68,9,413,"#660000"
"Governor","CN0059",146,359,11,505,"#2222aa"
"Governor","CN0060",8,34,0,42,"#000066"
"Governor","CN0061",128,196,9,324,"#4747eb"
"Governor","CN0062",893,1216,60,2109,"#8181f5"
"Governor","CN0063",98,46,2,144,"#cc3333"
"Governor","CN0064",6,2,0,8,"#881111"
"Governor","CN0065",166,463,27,629,"#2222aa"
"Governor","CN0066",298,69,6,367,"#660000"
"Governor","CN0067",182,293,21,475,"#4747eb"
"Governor","CN0069",229,449,23,678,"#3333cc"
"Governor","CN0070",57,97,8,154,"#4747eb"
"Governor","CN0071",30,49,3,79,"#4747eb"
"Governor","CN0072",386,183,24,569,"#cc3333"
"Governor","CN0073",406,196,18,602,"#cc3333"
"Governor","CN0074",219,188,18,407,"#ffaaae"
"Governor","CN0075",505,262,20,767,"#cc3333"
"Governor","CN0079",535,208,14,743,"#aa2222"
"Governor","CN0080",424,202,11,626,"#cc3333"
"Governor","CN0082",292,371,14,663,"#8181f5"
"Governor","CN0083",564,640,18,1204,"#aaaeff"
"Governor","CN0084",236,128,3,364,"#eb4747"
"Governor","CN0085",752,488,35,1240,"#eb4747"
"Governor","CN0086",107,52,3,159,"#cc3333"
"Governor","CN0088",68,159,11,227,"#2222aa"
"Governor","CN0090",202,747,51,949,"#111188"
"Governor","CN0092",657,518,38,1175,"#f58181"
"Governor","CN0093",128,382,16,510,"#2222aa"
"Governor","CN0094",89,293,20,382,"#111188"
"Governor","CN0095",400,1175,73,1575,"#2222aa"
"Governor","CN0097",247,139,14,386,"#eb4747"
"Governor","CN0098",1110,340,27,1450,"#881111"
"Governor","CN0099",420,172,15,592,"#aa2222"
"Governor","GI0100",260,89,10,349,"#aa2222"
"Governor","GI0105",81,62,5,143,"#f58181"
"Governor","GI0110",42,36,3,78,"#ffaaae"
"Governor","GI0115",220,151,17,371,"#f58181"
"Governor","GI0120",351,181,10,532,"#cc3333"
"Governor","GI0125",204,80,10,284,"#aa2222"
"Governor","GI0130",169,130,21,299,"#f58181"
"Governor","GI0135",342,114,10,456,"#881111"
"Governor","GI0140",342,168,8,510,"#cc3333"
"Governor","GI0150",153,78,13,231,"#cc3333"
"Governor","GI0155",136,158,17,294,"#aaaeff"
"Governor","GI0160",346,93,21,439,"#881111"
"Governor","GI0165",270,126,11,396,"#cc3333"
"Governor","GI0170",148,98,10,246,"#eb4747"
"Governor","GI0175",161,73,9,234,"#cc3333"
"Governor","GI0180",122,46,4,168,"#aa2222"
"Governor","GI0185",65,18,1,83,"#881111"
"Governor","GI0200",575,146,11,721,"#881111"
"Governor","GI0205",992,268,27,1260,"#881111"
"Governor","GI0210",1492,423,39,1915,"#881111"
"Governor","GI0215",544,183,6,727,"#aa2222"
"Governor","GI0220",871,259,21,1130,"#881111"
"Governor","GI0225",528,174,18,702,"#881111"
"Governor","GI0230",422,126,19,548,"#881111"
"Governor","GI0235",681,202,22,883,"#881111"
"Governor","GI0240",1310,296,19,1606,"#660000"
"Governor","GI0300",142,248,14,390,"#4747eb"
"Governor","GI0305",248,55,6,303,"#660000"
"Governor","GI0310",335,91,11,426,"#881111"
"Governor","GI0315",937,294,19,1231,"#881111"
"Governor","GI0320",119,19,3,138,"#660000"
"Governor","GI0325",75,15,1,90,"#660000"
"Governor","GI0330",715,129,11,844,"#660000"
"Governor","GI0335",140,37,3,177,"#881111"
"Governor","GI0340",340,51,1,391,"#660000"
"Governor","GI0345",309,90,5,399,"#881111"
"Governor","GI0400",54,184,4,238,"#111188"
"Governor","GI0405",4,10,0,14,"#2222aa"
"Governor","GI0410",199,622,28,821,"#111188"
"Governor","GM0001",417,164,21,581,"#aa2222"
"Governor","GM0002",542,238,16,780,"#cc3333"
"Governor","GM0003",297,70,9,367,"#660000"
"Governor","GM0004",208,117,11,325,"#eb4747"
"Governor","GM0005",594,219,21,813,"#aa2222"
"Governor","GM0006",423,80,4,503,"#660000"
"Governor","GM0007",852,197,20,1049,"#660000"
"Governor","GM0008",332,21,3,353,"#660000"
"Governor","GM0009",1182,179,29,1361,"#660000"
"Governor","GM0010",166,19,1,185,"#660000"
"Governor","GM0011",120,424,33,544,"#111188"
"Governor","GM0012",31,12,2,43,"#aa2222"
"Governor","GM0013",106,9,0,115,"#660000"
"Governor","GM0014",164,27,7,191,"#660000"
"Governor","GM0015",614,279,33,893,"#cc3333"
"Governor","GM0016",57,185,14,242,"#111188"
"Governor","GM0017",106,31,2,137,"#881111"
"Governor","GM0018",601,124,15,725,"#660000"
"Governor","GM0019",539,93,24,632,"#660000"
"Governor","GM0020",362,65,9,427,"#660000"
"Governor","GM0021",49,10,1,59,"#660000"
"Governor","GM0022",14,6,1,20,"#cc3333"
"Governor","GN0001",14,0,0,14,"#660000"
"Governor","GN0002",32,1,0,33,"#660000"
"Governor","GN0003",188,240,19,428,"#8181f5"
"Governor","GN0004",193,143,12,336,"#f58181"
"Governor","GN0005",352,160,12,512,"#cc3333"
"Governor","GN0006",92,52,4,144,"#eb4747"
"Governor","GN0007",329,116,16,445,"#aa2222"
"Governor","GN0008",437,120,17,557,"#881111"
"Governor","LP0051",869,493,47,1362,"#eb4747"
"Governor","LP0052",68,83,5,151,"#aaaeff"
"Governor","LP0054",896,162,21,1058,"#660000"
"Governor","LP0055",281,41,4,322,"#660000"
"Governor","LP0056",75,19,3,94,"#881111"
"Governor","LP0057",505,92,8,597,"#660000"
"Governor","LP0058",560,116,20,676,"#660000"
"Governor","LP0059",52,7,0,59,"#660000"
"Governor","LP0060",168,35,10,203,"#660000"
"Governor","LP0062",136,20,0,156,"#660000"
"Governor","LP0064",242,54,11,296,"#660000"
"Governor","MC0001",1102,989,93,2091,"#ffaaae"
"Governor","MC0002",1440,614,45,2054,"#aa2222"
"Governor","MC0003",286,930,31,1216,"#111188"
"Governor","MC0004",879,471,23,1350,"#cc3333"
"Governor","MC0005",2734,1535,54,4269,"#eb4747"
"Governor","MC0006",750,329,24,1079,"#cc3333"
"Governor","MC0007",163,54,3,217,"#881111"
"Governor","MC0008",1481,1337,56,2818,"#ffaaae"
"Governor","MC0009",701,608,42,1309,"#ffaaae"
"Governor","MC0010",924,1074,58,1998,"#aaaeff"
"Governor","MC0011",1946,1918,43,3864,"#ffd5d9"
"Governor","MC0012",170,316,15,486,"#3333cc"
"Governor","MC0013",1029,392,29,1421,"#aa2222"
"Governor","MC0014",261,142,7,403,"#eb4747"
"Governor","MC0015",706,270,19,976,"#aa2222"
"Governor","MC0016",346,495,21,841,"#8181f5"
"Governor","MC0017",637,564,23,1201,"#ffaaae"
"Governor","MC0018",672,564,27,1236,"#ffaaae"
"Governor","MC0019",762,711,35,1473,"#ffd5d9"
"Governor","MC0020",1784,1065,38,2849,"#eb4747"
"Governor","MC0021",1254,832,43,2086,"#eb4747"
"Governor","MC0022",621,239,42,860,"#aa2222"
"Governor","MC0023",909,444,38,1353,"#cc3333"
"Governor","MC0024",2330,993,78,3323,"#aa2222"
"Governor","MC0025",2286,1573,43,3859,"#f58181"
"Governor","MC0026",1983,662,33,2645,"#aa2222"
"Governor","MC0027",1029,1143,29,2172,"#aaaeff"
"Governor","MC0028",676,1468,62,2144,"#3333cc"
"Governor","MC0029",110,20,0,130,"#660000"
"Governor","MC0030",884,492,16,1376,"#eb4747"
"Governor","MC0031",1031,775,52,1806,"#f58181"
"Governor","MC0032",1078,630,24,1708,"#eb4747"
"Governor","MC0033",1032,593,50,1625,"#eb4747"
"Governor","MC0034",298,363,25,661,"#aaaeff"
"Governor","MC0035",1319,727,33,2046,"#eb4747"
"Governor","MC0036",1711,1061,13,2772,"#eb4747"
"Governor","MC0037",242,479,32,721,"#3333cc"
"Governor","MC0038",1651,836,75,2487,"#cc3333"
"Governor","MC0039",848,1398,51,2246,"#4747eb"
"Governor","MC0040",457,1240,50,1697,"#2222aa"
"Governor","MC0041",764,717,26,1481,"#ffd5d9"
"Governor","MC0042",2288,1617,59,3905,"#f58181"
"Governor","MC0043",2213,1076,45,3289,"#cc3333"
"Governor","MC0044",590,516,19,1106,"#ffaaae"
"Governor","MC0045",689,600,9,1289,"#ffaaae"
"Governor","MC0046",143,234,13,377,"#4747eb"
"Governor","MC0047",133,452,19,585,"#111188"
"Governor","MC0048",1115,826,11,1941,"#f58181"
"Governor","MC0049",1323,473,27,1796,"#aa2222"
"Governor","MC0050",1199,1273,92,2472,"#d5d9ff"
"Governor","MC0051",1541,560,35,2101,"#aa2222"
"Governor","MC0052",989,728,65,1717,"#f58181"
"Governor","MC0053",814,360,30,1174,"#cc3333"
"Governor","MC0054",633,203,13,836,"#881111"
"Governor","MC0055",1664,1421,96,3085,"#ffaaae"
"Governor","MC0056",1172,706,45,1878,"#eb4747"
"Governor","MC0057",1120,369,25,1489,"#881111"
"Governor","MC0058",115,163,16,278,"#8181f5"
"Governor","MC0059",1330,644,36,1974,"#cc3333"
"Governor","MC0060",1852,806,17,2658,"#cc3333"
"Governor","MC0061",2711,1248,49,3959,"#cc3333"
"Governor","MC0062",513,291,25,804,"#eb4747"
"Governor","MC0063",620,655,43,1275,"#d5d9ff"
"Governor","MC0064",1371,1017,58,2388,"#f58181"
"Governor","MC0065",69,29,3,98,"#aa2222"
"Governor","MC0066",808,562,31,1370,"#f58181"
"Governor","MC0067",151,69,5,220,"#cc3333"
"Governor","MC0068",366,875,30,1241,"#2222aa"
"Governor","MC0069",1652,1508,95,3160,"#ffd5d9"
"Governor","MC0070",1366,706,19,2072,"#cc3333"
"Governor","MC0071",616,1276,33,1892,"#3333cc"
"Governor","MC0072",567,365,27,932,"#eb4747"
"Governor","MC0073",631,637,13,1268,"#d5d9ff"
"Governor","MC0074",1399,579,52,1978,"#aa2222"
"Governor","MC0075",66,244,12,310,"#111188"
"Governor","MC0076",2077,1585,54,3662,"#f58181"
"Governor","MC0077",1832,640,54,2472,"#aa2222"
"Governor","MC0078",1779,729,32,2508,"#aa2222"
"Governor","MC0079",545,638,21,1183,"#aaaeff"
"Governor","MC0080",2413,833,56,3246,"#aa2222"
"Governor","MC0081",1200,951,28,2151,"#f58181"
"Governor","MC0082",141,63,2,204,"#cc3333"
"Governor","MC0083",1441,760,62,2201,"#cc3333"
"Governor","MC0084",367,795,27,1162,"#3333cc"
"Governor","MC0085",1231,1222,29,2453,"#ffd5d9"
"Governor","MC0086",1802,695,17,2497,"#aa2222"
"Governor","MC0087",484,990,44,1474,"#3333cc"
"Governor","MC0088",642,793,40,1435,"#8181f5"
"Governor","MC0089",1429,812,73,2241,"#eb4747"
"Governor","MC0090",860,655,47,1515,"#f58181"
"Governor","MC0091",961,966,66,1927,"#d5d9ff"
"Governor","MC0092",755,1219,53,1974,"#4747eb"
"Governor","MC0093",727,1818,76,2545,"#2222aa"
"Governor","MC0094",1347,593,19,1940,"#cc3333"
"Governor","MC0095",1682,1263,48,2945,"#f58181"
"Governor","MC0096",1794,780,22,2574,"#cc3333"
"Governor","MC0097",615,1149,52,1764,"#3333cc"
"Governor","MC0098",564,506,29,1070,"#ffaaae"
"Governor","MC0099",473,1198,44,1671,"#2222aa"
"Governor","MC0100",369,667,44,1036,"#4747eb"
"Governor","MC0101",2463,1196,34,3659,"#cc3333"
"Governor","MC0102",136,426,33,562,"#111188"
"Governor","MC0103",823,1943,69,2766,"#2222aa"
"Governor","MC0104",1795,684,14,2479,"#aa2222"
"Governor","MC0105",555,544,28,1099,"#ffd5d9"
"Governor","MC0106",960,903,55,1863,"#ffd5d9"
"Governor","MC0107",582,428,35,1010,"#f58181"
"Governor","MC0108",1546,880,32,2426,"#eb4747"
"Governor","MC0109",960,723,36,1683,"#f58181"
"Governor","MC0110",680,999,42,1679,"#8181f5"
"Governor","MC0111",1196,711,45,1907,"#eb4747"
"Governor","MC0112",1677,743,64,2420,"#cc3333"
"Governor","MC0113",336,111,1,447,"#881111"
"Governor","MC0114",1396,992,37,2388,"#f58181"
"Governor","MC0115",669,290,10,959,"#cc3333"
"Governor","MC0116",435,523,19,958,"#aaaeff"
"Governor","MC0117",1475,748,23,2223,"#cc3333"
"Governor","MC0118",332,279,16,611,"#ffaaae"
"Governor","MC0119",2031,1549,37,3580,"#f58181"
"Governor","MC0120",891,490,22,1381,"#eb4747"
"Governor","MC0121",590,1048,52,1638,"#4747eb"
"Governor","MC0122",1984,1657,84,3641,"#ffaaae"
"Governor","MC0123",821,1183,25,2004,"#8181f5"
"Governor","MC0124",266,512,34,778,"#3333cc"
"Governor","MC0125",1263,739,58,2002,"#eb4747"
"Governor","MC0126",382,642,25,1024,"#4747eb"
"Governor","MC0127",2022,1512,47,3534,"#f58181"
"Governor","MC0128",690,579,30,1269,"#ffaaae"
"Governor","MC0129",634,544,40,1178,"#ffaaae"
"Governor","MC0130",795,294,16,1089,"#aa2222"
"Governor","MC0131",501,433,33,934,"#ffaaae"
"Governor","MC0132",1230,797,23,2027,"#eb4747"
"Governor","MC0133",569,412,29,981,"#f58181"
"Governor","MC0134",170,420,28,590,"#2222aa"
"Governor","MC0135",1346,1485,57,2831,"#d5d9ff"
"Governor","MC0136",183,436,21,619,"#2222aa"
"Governor","MC0137",561,804,39,1365,"#8181f5"
"Governor","MC0138",168,294,22,462,"#4747eb"
"Governor","MC0139",594,629,27,1223,"#d5d9ff"
"Governor","MC0140",1096,1094,52,2190,"#ffd5d9"
"Governor","MC0141",1446,657,41,2103,"#cc3333"
"Governor","MC0142",328,369,25,697,"#aaaeff"
"Governor","MC0143",1680,1035,61,2715,"#eb4747"
"Governor","MC0144",2546,1003,56,3549,"#aa2222"
"Governor","MC0145",457,277,18,734,"#eb4747"
"Governor","MC0146",286,211,15,497,"#f58181"
"Governor","MC0147",1445,623,32,2068,"#cc3333"
"Governor","MC0148",773,490,23,1263,"#eb4747"
"Governor","MC0149",1782,640,51,2422,"#aa2222"
"Governor","MC0150",997,430,38,1427,"#cc3333"
"Governor","MC0151",1735,941,59,2676,"#eb4747"
"Governor","MC0152",518,1208,38,1726,"#3333cc"
"Governor","MC0153",717,231,28,948,"#881111"
"Governor","MC0154",1608,1442,80,3050,"#ffaaae"
"Governor","MC0155",814,365,47,1179,"#cc3333"
"Governor","MC0156",655,271,25,926,"#aa2222"
"Governor","MC0157",2184,1319,77,3503,"#eb4747"
"Governor","MC0158",1204,1511,89,2715,"#8181f5"
"Governor","MC0159",867,631,40,1498,"#f58181"
"Governor","MC0160",200,610,22,810,"#111188"
"Governor","MC0161",779,372,35,1151,"#cc3333"
"Governor","MC0162",677,419,49,1096,"#eb4747"
"Governor","MC0163",1480,701,66,2181,"#cc3333"
"Governor","MC0164",1174,611,39,1785,"#cc3333"
"Governor","MC0165",555,950,51,1505,"#4747eb"
"Governor","MC0166",383,832,39,1215,"#3333cc"
"Governor","MC0167",3113,1646,49,4759,"#cc3333"
"Governor","MC0168",2457,612,32,3069,"#660000"
"Governor","MC0169",1125,560,45,1685,"#cc3333"
"Governor","MC0170",358,305,14,663,"#ffaaae"
"Governor","MC0171",1599,927,21,2526,"#eb4747"
"Governor","MC0172",1062,1111,44,2173,"#d5d9ff"
"Governor","MC0173",913,958,41,1871,"#d5d9ff"
"Governor","MC0174",824,425,23,1249,"#cc3333"
"Governor","MC0175",707,797,38,1504,"#aaaeff"
"Governor","MC0176",1404,1087,60,2491,"#f58181"
"Governor","MC0177",1983,1048,65,3031,"#cc3333"
"Governor","MC0178",2149,1050,65,3199,"#cc3333"
"Governor","MC0179",1619,536,12,2155,"#881111"
"Governor","MC0180",2040,531,56,2571,"#881111"
"Governor","MC0181",804,692,34,1496,"#ffaaae"
"Governor","MC0182",2317,796,65,3113,"#aa2222"
"Governor","MC0183",2718,1345,70,4063,"#cc3333"
"Governor","MC0184",303,790,42,1093,"#2222aa"
"Governor","MC0185",1468,1315,71,2783,"#ffaaae"
"Governor","MC0186",764,585,22,1349,"#f58181"
"Governor","MC0187",612,554,20,1166,"#ffd5d9"
"Governor","MC0188",319,696,42,1015,"#3333cc"
"Governor","MC0189",1631,1553,62,3184,"#ffd5d9"
"Governor","MC0190",544,596,41,1140,"#d5d9ff"
"Governor","MC0191",3134,1436,56,4570,"#cc3333"
"Governor","MC0192",1380,2185,103,3565,"#4747eb"
"Governor","MC0193",757,525,16,1282,"#f58181"
"Governor","MC0194",1682,1660,63,3342,"#ffd5d9"
"Governor","MC0195",1477,742,11,2219,"#cc3333"
"Governor","MC0196",1163,519,19,1682,"#cc3333"
"Governor","MC0197",517,519,22,1036,"#d5d9ff"
"Governor","MC0198",2394,1027,112,3421,"#cc3333"
"Governor","MC0199",582,697,49,1279,"#aaaeff"
"Governor","MC0200",1124,786,27,1910,"#f58181"
"Governor","MC0201",2177,1098,54,3275,"#cc3333"
"Governor","MC0202",890,876,46,1766,"#ffd5d9"
"Governor","MC0203",806,749,39,1555,"#ffd5d9"
"Governor","MC0204",159,644,39,803,"#000066"
"Governor","MC0205",819,563,35,1382,"#f58181"
"Governor","MC0206",3920,1373,78,5293,"#aa2222"
"Governor","MC0207",516,1008,50,1524,"#3333cc"
"Governor","MC0208",1646,885,34,2531,"#cc3333"
"Governor","MC0209",441,273,21,714,"#eb4747"
"Governor","MC0210",573,348,16,921,"#eb4747"
"Governor","MC0211",1045,569,42,1614,"#eb4747"
"Governor","MC0212",463,472,41,935,"#d5d9ff"
"Governor","MC0213",206,820,32,1026,"#111188"
"Governor","MC0214",947,1262,79,2209,"#8181f5"
"Governor","MC0215",663,887,49,1550,"#8181f5"
"Governor","MC0216",940,1118,78,2058,"#aaaeff"
"Governor","MC0217",593,450,36,1043,"#f58181"
"Governor","MC0218",488,1307,65,1795,"#2222aa"
"Governor","MC0219",1371,551,36,1922,"#aa2222"
"Governor","MC0220",1189,1145,52,2334,"#ffd5d9"
"Governor","MC0221",595,1561,32,2156,"#2222aa"
"Governor","MC0222",1603,677,50,2280,"#aa2222"
"Governor","MC0223",1426,547,28,1973,"#aa2222"
"Governor","MC0224",450,1308,43,1758,"#2222aa"
"Governor","MC0225",469,411,26,880,"#ffaaae"
"Governor","MC0226",2091,1183,87,3274,"#eb4747"
"Governor","MC0227",729,1210,81,1939,"#4747eb"
"Governor","MC0228",2192,1276,62,3468,"#eb4747"
"Governor","MC0229",767,1429,61,2196,"#3333cc"
"Governor","MC0230",704,455,18,1159,"#eb4747"
"Governor","MC0231",807,634,36,1441,"#f58181"
"Governor","MC0232",2651,1173,77,3824,"#cc3333"
"Governor","MC0233",2576,974,65,3550,"#aa2222"
"Governor","MC0234",2419,918,49,3337,"#aa2222"
"Governor","MC0235",1398,1123,40,2521,"#f58181"
"Governor","MC0236",1687,1874,74,3561,"#aaaeff"
"Governor","MC0237",1888,1413,41,3301,"#f58181"
"Governor","MC0238",61,129,9,190,"#3333cc"
"Governor","MC0239",1471,630,30,2101,"#aa2222"
"Governor","MC0240",1944,948,51,2892,"#cc3333"
"Governor","MC0241",1289,1169,31,2458,"#ffd5d9"
"Governor","MC0242",795,505,17,1300,"#eb4747"
"Governor","MC0243",1147,481,47,1628,"#aa2222"
"Governor","MC0244",2317,1161,66,3478,"#cc3333"
"Governor","MC0245",3158,1977,61,5135,"#eb4747"
"Governor","MC0246",1764,1962,63,3726,"#aaaeff"
"Governor","MC0247",696,985,44,1681,"#8181f5"
"Governor","MC0248",145,445,12,590,"#111188"
"Governor","MC0249",254,1118,34,1372,"#000066"
"Governor","MC0250",1586,691,36,2277,"#cc3333"
"Governor","MC0251",1056,742,70,1798,"#f58181"
"Governor","MC0252",1263,526,23,1789,"#aa2222"
"Governor","MC0253",1215,977,44,2192,"#f58181"
"Governor","MC0254",522,489,29,1011,"#ffd5d9"
"Governor","MC0255",1056,1219,57,2275,"#aaaeff"
"Governor","MC0256",250,128,15,378,"#cc3333"
"Governor","MC0257",1167,795,43,1962,"#f58181"
"Governor","MC0258",1415,1052,54,2467,"#f58181"
"Governor","MC0259",758,554,52,1312,"#f58181"
"Governor","MC0260",812,799,25,1611,"#ffd5d9"
"Governor","MC0261",584,818,22,1402,"#8181f5"
"Governor","MC0262",1891,612,25,2503,"#881111"
"Governor","MC0263",625,478,19,1103,"#f58181"
"Governor","MC0264",2165,938,31,3103,"#cc3333"
"Governor","MC0265",1252,813,66,2065,"#eb4747"
"Governor","MC0266",144,44,1,188,"#881111"
"Governor","MC0267",334,412,39,746,"#8181f5"
"Governor","MC0268",445,966,41,1411,"#3333cc"
"Governor","MC0269",2924,1263,41,4187,"#cc3333"
"Governor","MC0270",2164,980,46,3144,"#cc3333"
"Governor","MC0271",2450,663,13,3113,"#881111"
"Governor","MC0272",1217,540,7,1757,"#cc3333"
"Governor","MC0273",1315,547,42,1862,"#aa2222"
"Governor","MC0274",268,914,38,1182,"#111188"
"Governor","MC0275",2144,1161,88,3305,"#eb4747"
"Governor","MC0276",1314,977,58,2291,"#f58181"
"Governor","MC0277",848,306,7,1154,"#aa2222"
"Governor","MC0278",932,744,47,1676,"#f58181"
"Governor","MC0279",1887,911,40,2798,"#cc3333"
"Governor","MC0280",184,996,44,1180,"#000066"
"Governor","MC0281",535,815,49,1350,"#4747eb"
"Governor","MC0282",345,674,27,1019,"#3333cc"
"Governor","MC0283",1061,1384,52,2445,"#8181f5"
"Governor","MC0284",503,113,8,616,"#660000"
"Governor","MC0285",1505,568,30,2073,"#aa2222"
"Governor","MC0286",1026,1147,79,2173,"#aaaeff"
"Governor","MC0287",1668,892,77,2560,"#cc3333"
"Governor","MC0288",62,38,1,100,"#eb4747"
"Governor","MC0289",262,281,19,543,"#d5d9ff"
"Governor","MC0290",92,458,21,550,"#000066"
"Governor","MC0291",72,45,2,117,"#eb4747"
"Governor","MC0292",1443,673,31,2116,"#cc3333"
"Governor","MC0293",768,734,50,1502,"#ffd5d9"
"Governor","MC0294",1031,486,58,1517,"#cc3333"
"Governor","MC0295",156,700,24,856,"#000066"
"Governor","MC0296",733,971,63,1704,"#8181f5"
"Governor","MC0297",381,1392,62,1773,"#111188"
"Governor","MC0298",2762,1075,47,3837,"#aa2222"
"Governor","MC0299",2,22,1,24,"#000066"
"Governor","MC0300",463,1282,55,1745,"#2222aa"
"Governor","MC0301",2337,1101,48,3438,"#cc3333"
"Governor","MC0302",2240,1215,57,3455,"#eb4747"
"Governor","MC0303",1355,576,27,1931,"#aa2222"
"Governor","MC0304",1227,651,20,1878,"#cc3333"
"Governor","MC0305",1477,936,38,2413,"#eb4747"
"Governor","MC0306",108,338,15,446,"#111188"
"Governor","MC0307",789,778,42,1567,"#ffd5d9"
"Governor","MC0308",153,390,22,543,"#2222aa"
"Governor","MC0309",466,1289,51,1755,"#2222aa"
"Governor","MC0310",681,1109,36,1790,"#4747eb"
"Governor","MC0311",247,584,25,831,"#2222aa"
"Governor","MC0312",296,855,32,1151,"#2222aa"
"Governor","MC0313",375,1066,55,1441,"#2222aa"
"Governor","MC0314",550,854,46,1404,"#4747eb"
"Governor","MC0315",392,1294,44,1686,"#111188"
"Governor","MC0316",1131,614,47,1745,"#eb4747"
"Governor","MC0317",1267,734,18,2001,"#eb4747"
"Governor","MC0318",1988,1272,44,3260,"#eb4747"
"Governor","MC0319",1932,1040,26,2972,"#cc3333"
"Governor","MC0320",613,621,18,1234,"#d5d9ff"
"Governor","MC0321",382,1159,51,1541,"#111188"
"Governor","MC0322",790,1014,51,1804,"#8181f5"
"Governor","MC0323",872,799,60,1671,"#ffd5d9"
"Governor","MC0324",705,1191,58,1896,"#4747eb"
"Governor","MC0325",1578,559,37,2137,"#aa2222"
"Governor","MC0326",106,456,21,562,"#000066"
"Governor","MC0327",2279,1545,83,3824,"#f58181"
"Governor","MC0328",1460,981,27,2441,"#f58181"
"Governor","MC0329",706,630,47,1336,"#ffaaae"
"Governor","MC0330",805,257,22,1062,"#881111"
"Governor","MC0331",811,814,36,1625,"#d5d9ff"
"Governor","MC0332",707,1231,34,1938,"#4747eb"
"Governor","MC0333",1452,719,39,2171,"#cc3333"
"Governor","MC0334",1405,969,68,2374,"#f58181"
"Governor","MC0335",660,295,18,955,"#cc3333"
"Governor","MC0336",1251,1271,28,2522,"#d5d9ff"
"Governor","MC0337",1355,851,22,2206,"#eb4747"
"Governor","MC0338",1028,1229,55,2257,"#aaaeff"
"Governor","MC0339",1093,586,13,1679,"#cc3333"
"Governor","MC0340",1174,1207,71,2381,"#d5d9ff"
"Governor","MC0341",701,941,49,1642,"#8181f5"
"Governor","MC0342",2019,999,55,3018,"#cc3333"
"Governor","MC0343",691,336,20,1027,"#cc3333"
"Governor","MC0344",1264,767,71,2031,"#eb4747"
"Governor","MC0345",558,271,4,829,"#cc3333"
"Governor","MC0346",891,1211,77,2102,"#8181f5"
"Governor","MC0347",738,263,19,1001,"#aa2222"
"Governor","MC0348",1413,1517,74,2930,"#d5d9ff"
"Governor","MC0349",59,151,10,210,"#2222aa"
"Governor","MC0350",635,571,23,1206,"#ffaaae"
"Governor","MC0351",2708,1014,41,3722,"#aa2222"
"Governor","MC0352",2536,950,43,3486,"#aa2222"
"Governor","MC0353",772,287,30,1059,"#aa2222"
"Governor","MC0354",1496,1416,38,2912,"#ffd5d9"
"Governor","MC0355",628,585,15,1213,"#ffd5d9"
"Governor","MC0356",2046,1503,30,3549,"#f58181"
"Governor","MC0357",1400,1001,60,2401,"#f58181"
"Governor","MC0358",1612,862,65,2474,"#cc3333"
"Governor","MC0359",2451,1043,35,3494,"#aa2222"
"Governor","MC0360",449,1059,60,1508,"#2222aa"
"Governor","MC0361",790,451,18,1241,"#eb4747"
"Governor","MC0362",334,854,33,1188,"#2222aa"
"Governor","MC0363",979,1966,93,2945,"#3333cc"
"Governor","MC0364",223,132,11,355,"#eb4747"
"Governor","MC0365",982,391,33,1373,"#aa2222"
"Governor","MC0366",1323,501,26,1824,"#aa2222"
"Governor","MC0367",205,504,27,709,"#2222aa"
"Governor","MC0368",843,435,43,1278,"#cc3333"
"Governor","MC0369",818,372,24,1190,"#cc3333"
"Governor","MC0370",1177,651,44,1828,"#eb4747"
"Governor","MC0371",688,483,28,1171,"#f58181"
"Governor","MC0372",1129,608,29,1737,"#eb4747"
"Governor","MC0373",1153,755,46,1908,"#eb4747"
"Governor","MC0374",695,1438,68,2133,"#3333cc"
"Governor","MC0375",1117,423,11,1540,"#aa2222"
"Governor","MC0376",2,5,0,7,"#2222aa"
"Governor","MC0377",3567,1400,57,4967,"#aa2222"
"Governor","MC0378",308,905,38,1213,"#2222aa"
"Governor","MC0379",1400,498,21,1898,"#aa2222"
"Governor","MC0380",1617,1259,38,2876,"#f58181"
"Governor","MC0381",273,388,39,661,"#8181f5"
"Governor","MC0382",1316,862,24,2178,"#eb4747"
"Governor","MC0383",1431,492,34,1923,"#aa2222"
"Governor","MC0384",1901,961,38,2862,"#cc3333"
"Governor","MC0385",176,446,16,622,"#2222aa"
"Governor","MC0386",2239,1411,92,3650,"#eb4747"
"Governor","MC0387",626,1072,54,1698,"#4747eb"
"Governor","MC0388",742,610,41,1352,"#ffaaae"
"Governor","MC0389",194,868,46,1062,"#000066"
"Governor","MC0390",834,698,11,1532,"#ffaaae"
"Governor","MC0391",707,1719,53,2426,"#2222aa"
"Governor","MC0392",252,786,40,1038,"#111188"
"Governor","MC0393",746,471,44,1217,"#eb4747"
"Governor","MC0394",1736,1893,72,3629,"#d5d9ff"
"Governor","MC0395",1581,662,32,2243,"#aa2222"
"Governor","MC0396",976,652,58,1628,"#f58181"
"Governor","MC0397",469,685,45,1154,"#8181f5"
"Governor","MC0398",510,451,29,961,"#ffaaae"
"Governor","MC0399",993,979,35,1972,"#ffd5d9"
"Governor","MC0400",600,531,28,1131,"#ffaaae"
"Governor","MC0401",561,655,47,1216,"#aaaeff"
"Governor","MC0402",411,1120,44,1531,"#2222aa"
"Governor","MC0403",1009,1467,66,2476,"#8181f5"
"Governor","MC0404",1161,749,44,1910,"#eb4747"
"Governor","MC0405",360,122,21,482,"#aa2222"
"Governor","MC0406",384,569,33,953,"#8181f5"
"Governor","MC0407",361,892,34,1253,"#2222aa"
"Governor","MC0408",947,1266,52,2213,"#8181f5"
"Governor","MC0409",338,346,21,684,"#d5d9ff"
"Governor","MC0410",2461,1703,43,4164,"#f58181"
"Governor","MC0411",346,305,10,651,"#ffaaae"
"Governor","MC0412",219,934,30,1153,"#000066"
"Governor","MC0413",921,1042,39,1963,"#aaaeff"
"Governor","MC0414",1074,1062,36,2136,"#ffd5d9"
"Governor","MC0415",3362,1814,103,5176,"#eb4747"
"Governor","MC0416",2195,1471,54,3666,"#f58181"
"Governor","MC0417",541,277,21,818,"#cc3333"
"Governor","MC0418",688,578,37,1266,"#ffaaae"
"Governor","MC0419",1270,899,44,2169,"#f58181"
"Governor","MC0420",2542,1280,99,3822,"#cc3333"
"Governor","MC0421",407,492,44,899,"#aaaeff"
"Governor","MC0422",598,317,20,915,"#cc3333"
"Governor","MC0423",1993,686,66,2679,"#aa2222"
"Governor","MC0424",167,486,37,653,"#2222aa"
"Governor","MC0425",1754,1437,46,3191,"#ffaaae"
"Governor","MC0426",1118,1064,80,2182,"#ffd5d9"
"Governor","MC0427",315,1093,36,1408,"#111188"
"Governor","MC0428",25,7,1,32,"#881111"
"Governor","MC0429",1363,1051,50,2414,"#f58181"
"Governor","MC0430",830,405,32,1235,"#cc3333"
"Governor","MC0431",393,1019,40,1412,"#2222aa"
"Governor","MC0432",1836,1379,61,3215,"#f58181"
"Governor","MC0433",190,546,16,736,"#2222aa"
"Governor","MC0434",279,499,32,778,"#4747eb"
"Governor","MC0435",1923,787,34,2710,"#aa2222"
"Governor","MC0436",1337,701,30,2038,"#cc3333"
"Governor","MC0437",441,112,5,553,"#881111"
"Governor","MC0438",1479,1169,50,2648,"#f58181"
"Governor","MC0439",2146,803,53,2949,"#aa2222"
"Governor","MC0440",1389,1132,38,2521,"#f58181"
"Governor","MC0441",1743,1606,48,3349,"#ffd5d9"
"Governor","MC0442",1917,1183,34,3100,"#eb4747"
"Governor","MC0443",1479,1102,48,2581,"#f58181"
"Governor","MC0444",2241,642,62,2883,"#881111"
"Governor","MC0445",638,680,48,1318,"#d5d9ff"
"Governor","MC0446",1215,815,26,2030,"#f58181"
"Governor","MC0447",2810,1594,45,4404,"#eb4747"
"Governor","MC0448",489,1408,49,1897,"#2222aa"
"Governor","MC0449",150,196,8,346,"#8181f5"
"Governor","MC0450",183,278,20,461,"#4747eb"
"Governor","MC0451",580,611,32,1191,"#d5d9ff"
"Governor","MC0452",467,294,10,761,"#eb4747"
"Governor","MC0453",1521,1411,40,2932,"#ffd5d9"
"Governor","MC0454",2972,1051,46,4023,"#aa2222"
"Governor","MC0455",3023,1219,101,4242,"#aa2222"
"Governor","MC0456",301,477,31,778,"#4747eb"
"Governor","MC0457",959,730,67,1689,"#f58181"
"Governor","MC0458",1340,533,47,1873,"#aa2222"
"Governor","MC0459",679,951,41,1630,"#8181f5"
"Governor","MC0460",881,855,35,1736,"#ffd5d9"
"Governor","MC0461",1143,1380,58,2523,"#aaaeff"
"Governor","MC0462",662,341,6,1003,"#cc3333"
"Governor","MC0463",599,711,26,1310,"#aaaeff"
"Governor","MC0464",1785,1260,74,3045,"#f58181"
"Governor","MC0465",879,1253,62,2132,"#8181f5"
"Governor","MC0466",965,917,60,1882,"#ffd5d9"
"Governor","MC0467",980,447,24,1427,"#cc3333"
"Governor","MC0468",1196,484,44,1680,"#aa2222"
"Governor","MC0469",900,1227,55,2127,"#8181f5"
"Governor","MC0470",1589,661,24,2250,"#aa2222"
"Governor","MC0471",104,96,7,200,"#ffd5d9"
"Governor","MC0472",933,623,22,1556,"#f58181"
"Governor","MC0473",440,502,18,942,"#aaaeff"
"Governor","MC0474",1052,1174,72,2226,"#aaaeff"
"Governor","MC0475",266,782,29,1048,"#2222aa"
"Governor","MC0476",750,1251,43,2001,"#4747eb"
"Governor","MC0477",1243,771,51,2014,"#eb4747"
"Governor","MC0478",1256,545,11,1801,"#cc3333"
"Governor","MC0479",1616,1313,84,2929,"#f58181"
"Governor","MC0480",1013,982,59,1995,"#ffd5d9"
"Governor","MC0481",291,641,31,932,"#3333cc"
"Governor","MC0482",397,1071,48,1468,"#2222aa"
"Governor","MC0483",485,270,18,755,"#eb4747"
"Governor","MC0484",856,612,41,1468,"#f58181"
"Governor","MC0485",811,2309,81,3120,"#2222aa"
"Governor","MC0486",718,355,5,1073,"#cc3333"
"Governor","MC0487",1872,1013,63,2885,"#eb4747"
"Governor","MC0488",1466,656,48,2122,"#cc3333"
"Governor","MC0489",1463,537,19,2000,"#aa2222"
"Governor","MC0490",4447,1712,69,6159,"#aa2222"
"Governor","MC0491",218,442,35,660,"#3333cc"
"Governor","MC0492",1992,1531,68,3523,"#f58181"
"Governor","MC0493",38,88,3,126,"#3333cc"
"Governor","MC0494",1047,504,23,1551,"#cc3333"
"Governor","MC0495",331,914,30,1245,"#2222aa"
"Governor","MC0496",233,344,22,577,"#8181f5"
"Governor","MC0497",607,643,44,1250,"#d5d9ff"
"Governor","MC0498",560,1105,72,1665,"#3333cc"
"Governor","MC0499",376,804,30,1180,"#3333cc"
"Governor","MC0500",970,498,35,1468,"#cc3333"
"Governor","MC0501",861,774,18,1635,"#ffaaae"
"Governor","MC0502",437,722,34,1159,"#4747eb"
"Governor","MC0503",1827,1051,80,2878,"#eb4747"
"Governor","MC0504",1060,912,30,1972,"#ffaaae"
"Governor","MC0505",1522,802,23,2324,"#cc3333"
"Governor","MC0506",3938,1317,28,5255,"#aa2222"
"Governor","MC0507",1436,666,19,2102,"#cc3333"
"Governor","MC0508",1434,1215,69,2649,"#ffaaae"
"Governor","MC0509",1461,983,22,2444,"#f58181"
"Governor","MC0510",778,431,19,1209,"#eb4747"
"Governor","MC0511",1406,870,38,2276,"#eb4747"
"Governor","MC0512",1292,488,31,1780,"#aa2222"
"Governor","MC0513",407,311,8,718,"#f58181"
"Governor","MC0514",577,485,36,1062,"#ffaaae"
"Governor","MC0515",721,707,40,1428,"#ffd5d9"
"Governor","MC0516",967,558,44,1525,"#eb4747"
"Governor","MC0517",1848,957,42,2805,"#cc3333"
"Governor","MC0518",2024,1255,49,3279,"#eb4747"
"Governor","MC0519",1170,1411,60,2581,"#aaaeff"
"Governor","MC0520",1087,1006,67,2093,"#ffd5d9"
"Governor","MC0521",3637,1811,84,5448,"#cc3333"
"Governor","MC0522",1991,1467,73,3458,"#f58181"
"Governor","MC0523",1801,571,43,2372,"#881111"
"Governor","MC0524",728,320,30,1048,"#cc3333"
"Governor","MC0525",898,1550,45,2448,"#4747eb"
"Governor","MC0526",1315,1213,81,2528,"#ffd5d9"
"Governor","MC0527",1508,668,20,2176,"#cc3333"
"Governor","MC0528",308,507,32,815,"#4747eb"
"Governor","MC0529",1769,891,51,2660,"#cc3333"
"Governor","MC0530",551,685,40,1236,"#8181f5"
"Governor","MC0531",1110,1019,40,2129,"#ffd5d9"
"Governor","MC0532",394,426,33,820,"#d5d9ff"
"Governor","MC0533",2205,1380,95,3585,"#eb4747"
"Governor","MC0534",534,411,21,945,"#f58181"
"Governor","MC0535",861,583,42,1444,"#f58181"
"Governor","MC0536",1385,559,36,1944,"#aa2222"
"Governor","MC0537",1216,642,9,1858,"#cc3333"
"Governor","MC0538",1071,711,30,1782,"#eb4747"
"Governor","MC0539",511,1420,40,1931,"#2222aa"
"Governor","MC0540",2705,713,34,3418,"#881111"
"Governor","MC0541",2693,967,57,3660,"#aa2222"
"Governor","MC0542",365,1134,51,1499,"#111188"
"Governor","MC0543",910,945,60,1855,"#d5d9ff"
"Governor","MC0544",684,399,37,1083,"#eb4747"
"Governor","MC0545",171,528,27,699,"#111188"
"Governor","MC0546",1686,1312,38,2998,"#f58181"
"Governor","MC0547",411,380,20,791,"#ffd5d9"
"Governor","MC0548",585,1527,75,2112,"#2222aa"
"Governor","MC0549",675,1086,47,1761,"#4747eb"
"Governor","MC0550",718,1587,72,2305,"#3333cc"
"Governor","MC0551",1613,1196,109,2809,"#f58181"
"Governor","MC0552",579,466,31,1045,"#f58181"
"Governor","MC0553",1136,1412,39,2548,"#8181f5"
"Governor","MC0554",773,984,31,1757,"#8181f5"
"Governor","MC0555",1310,613,54,1923,"#cc3333"
"Governor","MC0556",1019,1783,82,2802,"#4747eb"
"Governor","MC0557",2066,645,57,2711,"#881111"
"Governor","MC0558",2704,1288,58,3992,"#cc3333"
"Governor","MC0559",1978,768,27,2746,"#aa2222"
"Governor","MC0560",686,506,43,1192,"#f58181"
"Governor","MC0561",278,49,3,327,"#660000"
"Governor","MC0562",853,835,47,1688,"#ffd5d9"
"Governor","MC0563",1053,549,30,1602,"#cc3333"
"Governor","MC0564",13,47,2,60,"#111188"
"Governor","MC0565",616,741,25,1357,"#aaaeff"
"Governor","MC0566",1939,979,64,2918,"#cc3333"
"Governor","MC0567",265,333,15,598,"#8181f5"
"Governor","MC0568",97,64,4,161,"#eb4747"
"Governor","MC0569",593,464,25,1057,"#f58181"
"Governor","MC0570",528,473,12,1001,"#ffaaae"
"Governor","MC0571",912,689,28,1601,"#f58181"
"Governor","MC0572",984,1041,27,2025,"#d5d9ff"
"Governor","MC0573",1266,641,23,1907,"#cc3333"
"Governor","MC0574",695,537,32,1232,"#f58181"
"Governor","MC0575",198,565,14,763,"#2222aa"
"Governor","MC0576",1140,302,25,1442,"#881111"
"Governor","MC0577",1331,792,29,2123,"#eb4747"
"Governor","MC0578",1107,471,47,1578,"#aa2222"
"Governor","MC0579",1130,646,38,1776,"#eb4747"
"Governor","MC0580",1707,1401,39,3108,"#ffaaae"
"Governor","MC0581",1220,1497,39,2717,"#8181f5"
"Governor","MC0582",499,1279,50,1778,"#2222aa"
"Governor","MC0583",24,10,0,34,"#aa2222"
"Governor","MC0584",1385,931,32,2316,"#f58181"
"Governor","MC0585",833,1449,72,2282,"#4747eb"
"Governor","MC0586",2485,1339,45,3824,"#eb4747"
"Governor","MC0587",1145,855,17,2000,"#f58181"
"Governor","MC0588",674,427,39,1101,"#eb4747"
"Governor","MC0589",740,917,44,1657,"#8181f5"
"Governor","MC0590",1719,607,52,2326,"#aa2222"
"Governor","MC0591",896,760,54,1656,"#ffaaae"
"Governor","MC0592",694,577,26,1271,"#ffaaae"
"Governor","MC0593",1226,992,27,2218,"#f58181"
"Governor","MC0594",1706,831,21,2537,"#cc3333"
"Governor","MC0595",1272,893,53,2165,"#f58181"
"Governor","MC0596",1827,1339,22,3166,"#f58181"
"Governor","MC0597",813,449,19,1262,"#eb4747"
"Governor","MC0598",383,1153,49,1536,"#111188"
"Governor","MC0599",598,363,21,961,"#eb4747"
"Governor","MC0600",2243,1195,32,3438,"#cc3333"
"Governor","MC0601",701,1600,85,2301,"#3333cc"
"Governor","MC0602",838,1178,47,2016,"#8181f5"
"Governor","MC0603",820,258,22,1078,"#881111"
"Governor","MC0604",796,520,31,1316,"#eb4747"
"Governor","MC0605",1,1,0,2,"#ffd5d9"
"Governor","MC0606",2,4,0,6,"#3333cc"
"Governor","MC0607",10,7,0,17,"#f58181"
"Governor","MC0608",729,1370,46,2099,"#3333cc"
"Governor","MC0609",511,508,8,1019,"#ffd5d9"
"Governor","MC0610",633,1019,63,1652,"#4747eb"
"Governor","MC0611",2505,774,37,3279,"#881111"
"Governor","MC0612",3359,1237,84,4596,"#aa2222"
"Governor","MC0613",239,811,43,1050,"#111188"
"Governor","MC0614",78,105,2,183,"#8181f5"
"Governor","MC0620",312,1287,53,1599,"#000066"
"Governor","MC0621",1091,411,30,1502,"#aa2222"
"Governor","MC0622",545,562,17,1107,"#d5d9ff"
"Governor","MC0623",208,258,20,466,"#8181f5"
"Governor","MC0624",2091,1332,71,3423,"#eb4747"
"Governor","MC0625",67,24,0,91,"#aa2222"
"Governor","MC0626",698,244,22,942,"#aa2222"
"Governor","MC0627",475,629,16,1104,"#8181f5"
"Governor","MC0628",841,498,38,1339,"#eb4747"
"Governor","MC0629",735,275,18,1010,"#aa2222"
"Governor","MC0630",281,702,40,983,"#2222aa"
"Governor","MC0631",423,666,39,1089,"#4747eb"
"Governor","MC0632",1646,1473,59,3119,"#ffaaae"
"Governor","MC0633",988,490,6,1478,"#cc3333"
"Governor","MC0634",19,14,2,33,"#f58181"
"Governor","MC0635",755,2104,64,2859,"#2222aa"
"Governor","MC0636",798,290,26,1088,"#aa2222"
"Governor","MC0637",1583,877,76,2460,"#eb4747"
"Governor","MC0638",1438,551,71,1989,"#aa2222"
"Governor","MC0639",200,403,8,603,"#3333cc"
"Governor","MC0640",1253,975,42,2228,"#f58181"
"Governor","MC0641",1263,465,47,1728,"#aa2222"
"Governor","MC0642",1879,950,65,2829,"#cc3333"
"Governor","MC0643",663,467,33,1130,"#f58181"
"Governor","MC0644",1368,983,92,2351,"#f58181"
"Governor","MC0645",599,443,43,1042,"#f58181"
"Governor","MC0646",1544,994,47,2538,"#eb4747"
"Governor","MC0647",1061,717,8,1778,"#f58181"
"Governor","MC0648",3,0,0,3,"#660000"
"Governor","MC0649",246,877,44,1123,"#111188"
"Governor","MC0650",2711,1242,75,3953,"#cc3333"
"Governor","MC0651",1636,1648,53,3284,"#d5d9ff"
"Governor","MC0652",561,311,12,872,"#eb4747"
"Governor","MC0653",391,608,37,999,"#4747eb"
"Governor","MC0654",2047,938,48,2985,"#cc3333"
"Governor","MC0655",1128,820,80,1948,"#f58181"
"Governor","MC0656",691,547,33,1238,"#f58181"
"Governor","MC0657",407,479,22,886,"#aaaeff"
"Governor","MC0658",375,543,32,918,"#8181f5"
"Governor","MC0659",2347,1233,80,3580,"#cc3333"
"Governor","MC0660",820,526,16,1346,"#eb4747"
"Governor","MC0661",979,665,42,1644,"#f58181"
"Governor","MC0662",26,5,0,31,"#660000"
"Governor","MC0663",1167,622,43,1789,"#cc3333"
"Governor","MC0664",941,394,27,1335,"#aa2222"
"Governor","MC0665",2937,2027,59,4964,"#f58181"
"Governor","MC0666",2486,986,25,3472,"#aa2222"
"Governor","MC0667",237,300,10,537,"#8181f5"
"Governor","MC0668",927,390,30,1317,"#aa2222"
"Governor","MC0669",1640,705,31,2345,"#cc3333"
"Governor","MC0670",355,1064,53,1419,"#2222aa"
"Governor","MC0671",628,190,21,818,"#881111"
"Governor","MC0672",1877,913,56,2790,"#cc3333"
"Governor","MC0673",8,2,0,10,"#660000"
"Governor","MC0674",1194,629,25,1823,"#cc3333"
"Governor","MC0675",190,322,24,512,"#4747eb"
"Governor","MC0676",1493,518,29,2011,"#aa2222"
"Governor","MC0677",2335,1256,58,3591,"#cc3333"
"Governor","MC0678",201,650,25,851,"#111188"
"Governor","MC0679",4160,1964,78,6124,"#cc3333"
"Governor","MC0680",191,351,25,542,"#4747eb"
"Governor","MC0681",796,1225,51,2021,"#4747eb"
"Governor","MC0682",344,997,54,1341,"#2222aa"
"Governor","MC0683",469,329,18,798,"#f58181"
"Governor","MC0684",622,1976,64,2598,"#111188"
"Governor","MC0685",4398,1984,107,6382,"#cc3333"
"Governor","MC0686",498,1093,34,1591,"#3333cc"
"Governor","MC0687",124,99,10,223,"#f58181"
"Governor","MC0688",1250,616,39,1866,"#cc3333"
"Governor","MC0689",535,610,41,1145,"#aaaeff"
"Governor","MC0690",1234,859,65,2093,"#f58181"
"Governor","MC0691",517,461,17,978,"#ffaaae"
"Governor","MC0692",1029,939,56,1968,"#ffd5d9"
"Governor","MC0693",674,830,43,1504,"#8181f5"
"Governor","MC0694",402,670,41,1072,"#4747eb"
"Governor","MC0695",550,586,32,1136,"#d5d9ff"
"Governor","MC0696",801,566,22,1367,"#f58181"
"Governor","MC0697",626,992,42,1618,"#4747eb"
"Governor","MC0698",800,1009,42,1809,"#8181f5"
"Governor","MC0699",1146,887,47,2033,"#f58181"
"Governor","MC0700",224,77,3,301,"#aa2222"
"Governor","MC0701",3013,1376,45,4389,"#cc3333"
"Governor","MC0702",1199,1007,68,2206,"#ffaaae"
"Governor","MC0703",1145,645,50,1790,"#eb4747"
"Governor","MC0704",3745,1333,87,5078,"#aa2222"
"Governor","MC0705",1421,1377,30,2798,"#ffd5d9"
"Governor","MC0706",1435,837,50,2272,"#eb4747"
"Governor","MC0707",746,1385,63,2131,"#4747eb"
"Governor","MC0708",1040,1089,49,2129,"#d5d9ff"
"Governor","MC0709",519,155,10,674,"#881111"
"Governor","MC0710",225,484,25,709,"#3333cc"
"Governor","MC0711",607,541,18,1148,"#ffaaae"
"Governor","MC0712",531,870,53,1401,"#4747eb"
"Governor","MC0713",2311,1409,109,3720,"#eb4747"
"Governor","MC0714",3609,1583,57,5192,"#cc3333"
"Governor","MC0715",1440,755,34,2195,"#cc3333"
"Governor","MC0716",1954,751,46,2705,"#aa2222"
"Governor","MC0717",948,1154,50,2102,"#aaaeff"
"Governor","MC0718",897,706,50,1603,"#f58181"
"Governor","MC0719",345,857,27,1202,"#2222aa"
"Governor","MC0720",513,1875,55,2388,"#111188"
"Governor","MC0721",1030,603,41,1633,"#eb4747"
"Governor","MC0722",2879,1772,41,4651,"#eb4747"
"Governor","MC0723",257,109,7,366,"#aa2222"
"Governor","MC0724",1605,898,45,2503,"#eb4747"
"Governor","MC0725",189,832,22,1021,"#000066"
"Governor","MC0726",147,119,2,266,"#f58181"
"Governor","MC0727",1169,1055,69,2224,"#ffaaae"
"Governor","MC0728",2718,653,53,3371,"#660000"
"Governor","MC0729",795,386,40,1181,"#cc3333"
"Governor","MC0730",3339,2022,82,5361,"#eb4747"
"Governor","MC0731",1146,823,50,1969,"#f58181"
"Governor","MC0732",651,420,32,1071,"#eb4747"
"Governor","MC0733",1363,1148,32,2511,"#ffaaae"
"Governor","MC0734",870,873,42,1743,"#d5d9ff"
"Governor","MC0735",1268,592,32,1860,"#cc3333"
"Governor","MC0736",827,665,32,1492,"#f58181"
"Governor","MC0737",1513,807,66,2320,"#cc3333"
"Governor","MC0738",634,1922,24,2556,"#111188"
"Governor","MC0739",1999,2089,83,4088,"#d5d9ff"
"Governor","MC0740",1374,331,35,1705,"#660000"
"Governor","MC0741",2058,673,17,2731,"#881111"
"Governor","MC0742",929,704,40,1633,"#f58181"
"Governor","MC0743",1069,1207,61,2276,"#aaaeff"
"Governor","MC0744",501,1182,36,1683,"#2222aa"
"Governor","MC0745",966,609,60,1575,"#eb4747"
"Governor","MC0746",776,833,41,1609,"#d5d9ff"
"Governor","MC0747",689,715,29,1404,"#d5d9ff"
"Governor","MC0748",2370,920,45,3290,"#aa2222"
"Governor","MO0201",132,16,0,148,"#660000"
"Governor","MO0202",100,38,5,138,"#aa2222"
"Governor","MO0203",328,67,8,395,"#660000"
"Governor","MO0204",295,55,5,350,"#660000"
"Governor","MO0205",762,41,15,803,"#660000"
"Governor","MO0206",58,11,3,69,"#660000"
"Governor","MO0207",1049,210,20,1259,"#660000"
"Governor","MO0208",501,116,9,617,"#660000"
"Governor","MO0209",462,144,15,606,"#881111"
"Governor","MO0210",3017,624,81,3641,"#660000"
"Governor","MO0211",9133,2679,217,11812,"#881111"
"Governor","MO0212",5860,1484,132,7344,"#881111"
"Governor","MO0213",1046,207,25,1253,"#660000"
"Governor","MO0214",84,11,0,95,"#660000"
"Governor","MO0215",2260,685,90,2945,"#881111"
"Governor","MO0216",2881,709,117,3590,"#660000"
"Governor","MO0217",4084,1079,99,5163,"#881111"
"Governor","MO0218",4443,1022,133,5465,"#660000"
"Governor","MO0219",5319,970,83,6289,"#660000"
"Governor","MO0220",13570,2889,228,16459,"#660000"
"Governor","MO0221",598,233,11,831,"#aa2222"
"Governor","MO0222",603,139,20,742,"#660000"
"Governor","MO0223",46,22,2,68,"#cc3333"
"Governor","MO0224",51,129,7,180,"#2222aa"
"Governor","NA0001",1271,3735,267,5006,"#2222aa"
"Governor","NA0002",249,526,27,775,"#3333cc"
"Governor","NA0003",108,74,6,182,"#f58181"
"Governor","NA0004",1672,2512,170,4184,"#4747eb"
"Governor","NA0005",269,655,35,924,"#2222aa"
"Governor","NA0006",76,312,28,388,"#000066"
"Governor","NA0007",4453,512,101,4965,"#660000"
"Governor","NA0008",1507,634,59,2141,"#aa2222"
"Governor","NA0009",778,187,21,965,"#660000"
"Governor","NA0010",626,81,15,707,"#660000"
"Governor","NA0011",1744,333,45,2077,"#660000"
"Governor","NA0012",623,161,16,784,"#881111"
"Governor","NA0013",4744,1076,105,5820,"#660000"
"Governor","NA0014",3760,2848,160,6608,"#f58181"
"Governor","PM0001",491,412,26,903,"#ffaaae"
"Governor","PM0002",64,53,1,117,"#ffaaae"
"Governor","PM0003",22,112,10,134,"#000066"
"Governor","PM0004",119,473,22,592,"#111188"
"Governor","PM0005",1691,573,89,2264,"#aa2222"
"Governor","PM0006",1118,659,44,1777,"#eb4747"
"Governor","PM0007",49,31,2,80,"#eb4747"
"Governor","PM0008",184,184,11,368,"#ffd5d9"
"Governor","PM0009",916,982,38,1898,"#d5d9ff"
"Governor","PM0010",976,638,27,1614,"#eb4747"
"Governor","PM0011",1562,470,43,2032,"#881111"
"Governor","PM0012",2147,1553,35,3700,"#f58181"
"Governor","PM0013",1017,952,51,1969,"#ffd5d9"
"Governor","PM0014",1357,996,41,2353,"#f58181"
"Governor","PM0015",569,360,38,929,"#eb4747"
"Governor","PM0016",916,1573,38,2489,"#4747eb"
"Governor","PM0017",292,951,33,1243,"#111188"
"Governor","PM0018",249,1120,46,1369,"#000066"
"Governor","PM0019",201,109,6,310,"#eb4747"
"Governor","PM0020",370,1125,71,1495,"#111188"
"Governor","PM0021",1220,1009,47,2229,"#ffaaae"
"Governor","PM0022",666,1158,53,1824,"#4747eb"
"Governor","PM0023",657,1276,62,1933,"#3333cc"
"Governor","PM0024",850,516,35,1366,"#eb4747"
"Governor","PM0025",292,931,47,1223,"#111188"
"Governor","PM0026",322,1059,49,1381,"#111188"
"Governor","PM0027",0,0,0,0,NA
"Governor","PM0028",183,632,15,815,"#111188"
"Governor","PM0029",1447,1065,39,2512,"#f58181"
"Governor","PM0030",1003,1171,23,2174,"#aaaeff"
"Governor","PM0031",628,483,36,1111,"#f58181"
"Governor","PM0032",1437,1315,94,2752,"#ffd5d9"
"Governor","PM0033",562,918,28,1480,"#4747eb"
"Governor","PM0034",397,397,37,794,"#ffd5d9"
"Governor","PM0035",258,204,9,462,"#f58181"
"Governor","PM0036",793,1108,71,1901,"#8181f5"
"Governor","PM0037",193,529,18,722,"#2222aa"
"Governor","PM0038",491,764,45,1255,"#4747eb"
"Governor","PM0039",1526,964,54,2490,"#eb4747"
"Governor","PM0040",996,739,48,1735,"#f58181"
"Governor","PM0041",1176,1800,97,2976,"#4747eb"
"Governor","PM0042",379,1790,59,2169,"#000066"
"Governor","PM0043",182,500,30,682,"#2222aa"
"Governor","PM0044",202,1130,36,1332,"#000066"
"Governor","PM0045",133,1059,34,1192,"#000066"
"Governor","PM0046",526,268,10,794,"#cc3333"
"Governor","PM0047",312,1061,49,1373,"#111188"
"Governor","PM0048",372,722,24,1094,"#3333cc"
"Governor","PM0049",580,338,32,918,"#eb4747"
"Governor","PM0050",246,879,39,1125,"#111188"
"Governor","PM0051",187,650,36,837,"#111188"
"Governor","PM0052",225,782,45,1007,"#111188"
"Governor","PM0053",641,1627,83,2268,"#2222aa"
"Governor","PM0054",948,1605,83,2553,"#4747eb"
"Governor","PM0055",329,580,11,909,"#4747eb"
"Governor","PM0056",700,1220,19,1920,"#4747eb"
"Governor","PM0057",621,1498,65,2119,"#2222aa"
"Governor","PM0058",422,1359,67,1781,"#111188"
"Governor","PM0059",309,668,29,977,"#3333cc"
"Governor","PM0060",525,351,26,876,"#f58181"
"Governor","PM0061",796,795,28,1591,"#ffd5d9"
"Governor","PM0062",194,932,23,1126,"#000066"
"Governor","PM0063",252,842,18,1094,"#111188"
"Governor","PM0064",212,817,40,1029,"#111188"
"Governor","PM0065",9,8,0,17,"#ffaaae"
"Governor","PM0066",265,933,41,1198,"#111188"
"Governor","PM0067",512,1050,60,1562,"#3333cc"
"Governor","PM0068",489,1263,41,1752,"#2222aa"
"Governor","PM0069",1594,1439,78,3033,"#ffaaae"
"Governor","PM0070",855,590,48,1445,"#f58181"
"Governor","PM0071",24,76,3,100,"#111188"
"Governor","PM0072",667,1430,92,2097,"#3333cc"
"Governor","PM0073",414,1647,51,2061,"#111188"
"Governor","PM0074",1021,658,28,1679,"#eb4747"
"Governor","PM0075",481,1464,74,1945,"#111188"
"Governor","PM0076",39,152,11,191,"#111188"
"Governor","PM0077",1166,768,17,1934,"#eb4747"
"Governor","PM0078",260,1072,11,1332,"#000066"
"Governor","PM0079",1331,866,38,2197,"#eb4747"
"Governor","PM0080",381,1181,39,1562,"#111188"
"Governor","PM0081",480,309,17,789,"#eb4747"
"Governor","PM0082",339,1178,34,1517,"#111188"
"Governor","PM0083",833,368,28,1201,"#cc3333"
"Governor","PM0084",2482,1273,44,3755,"#cc3333"
"Governor","PM0085",456,603,37,1059,"#8181f5"
"Governor","PM0086",704,1556,66,2260,"#3333cc"
"Governor","PM0087",149,272,10,421,"#4747eb"
"Governor","PM0088",1028,1117,12,2145,"#d5d9ff"
"Governor","PM0089",742,1267,46,2009,"#4747eb"
"Governor","PM0090",622,408,38,1030,"#eb4747"
"Governor","PM0091",617,1188,60,1805,"#3333cc"
"Governor","PM0092",1095,1232,33,2327,"#aaaeff"
"Governor","PM0093",417,1052,40,1469,"#2222aa"
"Governor","PM0094",460,1203,31,1663,"#2222aa"
"Governor","PM0095",574,308,16,882,"#cc3333"
"Governor","PM0096",533,1263,38,1796,"#2222aa"
"Governor","PM0097",376,863,36,1239,"#3333cc"
"Governor","PM0098",572,1077,59,1649,"#3333cc"
"Governor","PM0099",622,1102,30,1724,"#4747eb"
"Governor","PM0100",695,1008,58,1703,"#8181f5"
"Governor","PM0101",675,514,42,1189,"#f58181"
"Governor","PM0102",509,820,50,1329,"#4747eb"
"Governor","PM0103",296,607,13,903,"#3333cc"
"Governor","PM0104",1488,1137,44,2625,"#f58181"
"Governor","PM0105",423,523,46,946,"#8181f5"
"Governor","PM0106",622,522,11,1144,"#ffaaae"
"Governor","PM0107",817,1215,56,2032,"#8181f5"
"Governor","PM0108",1044,1666,60,2710,"#4747eb"
"Governor","PM0109",2042,1083,52,3125,"#cc3333"
"Governor","PM0110",105,665,36,770,"#000066"
"Governor","PM0111",634,827,41,1461,"#8181f5"
"Governor","PM0112",1152,1086,23,2238,"#ffd5d9"
"Governor","PM0113",771,871,62,1642,"#aaaeff"
"Governor","PM0114",177,152,13,329,"#ffaaae"
"Governor","PM0115",1788,1183,39,2971,"#eb4747"
"Governor","PM0116",1328,1199,68,2527,"#ffaaae"
"Governor","PM0117",766,855,44,1621,"#aaaeff"
"Governor","PM0118",1006,1121,49,2127,"#aaaeff"
"Governor","PM0119",653,714,35,1367,"#d5d9ff"
"Governor","PM0120",906,967,59,1873,"#d5d9ff"
"Governor","PM0121",751,597,22,1348,"#f58181"
"Governor","PM0122",657,579,55,1236,"#ffaaae"
"Governor","PM0123",1190,1142,97,2332,"#ffd5d9"
"Governor","PM0124",518,447,33,965,"#ffaaae"
"Governor","PM0125",776,736,12,1512,"#ffd5d9"
"Governor","PM0126",703,438,12,1141,"#eb4747"
"Governor","PM0127",3428,1855,46,5283,"#eb4747"
"Governor","PM0128",838,796,31,1634,"#ffd5d9"
"Governor","PM0129",661,670,39,1331,"#d5d9ff"
"Governor","PM0130",1205,992,62,2197,"#ffaaae"
"Governor","PM0131",856,662,29,1518,"#f58181"
"Governor","PM0132",1097,901,53,1998,"#ffaaae"
"Governor","PM0133",1162,909,76,2071,"#f58181"
"Governor","PM0134",765,599,25,1364,"#f58181"
"Governor","PM0135",12,104,2,116,"#000066"
"Governor","PM0136",7,64,4,71,"#000066"
"Governor","PM0137",10,72,2,82,"#000066"
"Governor","PM0138",38,239,13,277,"#000066"
"Governor","PM0139",124,153,14,277,"#8181f5"
"Governor","PM0140",289,160,5,449,"#eb4747"
"Governor","PM0141",2047,1349,57,3396,"#eb4747"
"Governor","PM0142",1239,920,42,2159,"#f58181"
"Governor","PM0143",60,580,16,640,"#000066"
"Governor","PM0144",517,1113,54,1630,"#3333cc"
"Governor","PM0145",2489,1635,46,4124,"#eb4747"
"Governor","PM0146",867,835,33,1702,"#ffd5d9"
"Governor","PM0147",865,606,41,1471,"#f58181"
"Governor","PM0148",831,772,27,1603,"#ffd5d9"
"Governor","PM0149",718,789,20,1507,"#d5d9ff"
"Governor","PM0150",182,194,11,376,"#d5d9ff"
"Governor","PM0151",299,398,5,697,"#8181f5"
"Governor","PM0152",148,359,20,507,"#2222aa"
"Governor","PM0153",839,1383,61,2222,"#4747eb"
"Governor","PM0154",265,551,37,816,"#3333cc"
"Governor","PM0155",213,423,23,636,"#3333cc"
"Governor","PM0156",677,538,42,1215,"#f58181"
"Governor","PM0157",407,1044,49,1451,"#2222aa"
"Governor","PM0158",662,810,14,1472,"#8181f5"
"Governor","PM0159",482,1338,45,1820,"#2222aa"
"Governor","PM0160",155,591,16,746,"#111188"
"Governor","PM0161",430,227,9,657,"#cc3333"
"Governor","PM0162",545,688,22,1233,"#8181f5"
"Governor","PM0163",844,802,10,1646,"#ffd5d9"
"Governor","PM0164",453,1273,27,1726,"#2222aa"
"Governor","PM0165",181,66,3,247,"#aa2222"
"Governor","PM0166",389,1382,52,1771,"#111188"
"Governor","PM0167",270,934,33,1204,"#111188"
"Governor","PM0168",446,214,15,660,"#cc3333"
"Governor","PM0169",1752,1117,39,2869,"#eb4747"
"Governor","PM0170",714,1019,26,1733,"#8181f5"
"Governor","PM0171",1200,963,19,2163,"#f58181"
"Governor","PM0172",1601,975,39,2576,"#eb4747"
"Governor","PM0173",1256,839,25,2095,"#f58181"
"Governor","PM0174",1051,1108,49,2159,"#d5d9ff"
"Governor","PM0175",1053,551,30,1604,"#cc3333"
"Governor","PM0176",744,474,36,1218,"#eb4747"
"Governor","PM0177",1216,986,64,2202,"#f58181"
"Governor","PM0178",1107,804,38,1911,"#f58181"
"Governor","PM0179",1727,1087,41,2814,"#eb4747"
"Governor","PM0180",1219,1019,61,2238,"#ffaaae"
"Governor","PM0181",1446,1024,40,2470,"#f58181"
"Governor","PM0182",1336,1035,63,2371,"#f58181"
"Governor","PM0183",947,688,45,1635,"#f58181"
"Governor","PM0184",1495,683,35,2178,"#cc3333"
"Governor","PM0185",663,533,29,1196,"#f58181"
"Governor","PM0186",134,100,6,234,"#f58181"
"Governor","PM0187",1471,1070,35,2541,"#f58181"
"Governor","PM0188",1253,696,44,1949,"#eb4747"
"Governor","PM0189",382,660,23,1042,"#4747eb"
"Governor","PM0190",263,573,30,836,"#3333cc"
"Governor","PM0191",420,350,13,770,"#ffaaae"
"Governor","PM0192",1165,953,66,2118,"#f58181"
"Governor","PM0193",803,493,21,1296,"#eb4747"
"Governor","PM0194",1603,938,19,2541,"#eb4747"
"Governor","PM0195",936,497,15,1433,"#cc3333"
"Governor","PM0196",2,3,0,5,"#8181f5"
"Governor","PM0197",884,550,42,1434,"#eb4747"
"Governor","PM0198",1036,432,32,1468,"#aa2222"
"Governor","PM0199",1317,764,34,2081,"#eb4747"
"Governor","PM0200",735,362,17,1097,"#cc3333"
"Governor","PM0201",940,919,42,1859,"#ffd5d9"
"Governor","PM0202",1343,1019,31,2362,"#f58181"
"Governor","PM0203",390,477,18,867,"#8181f5"
"Governor","PM0204",293,49,4,342,"#660000"
"Governor","PM0205",1517,798,28,2315,"#cc3333"
"Governor","PM0206",215,108,11,323,"#cc3333"
"Governor","PM0207",1289,979,30,2268,"#f58181"
"Governor","PM0208",552,350,35,902,"#eb4747"
"Governor","PM0209",1417,727,27,2144,"#cc3333"
"Governor","PM0210",708,1107,23,1815,"#4747eb"
"Governor","PM0211",889,854,15,1743,"#ffd5d9"
"Governor","PM0212",671,483,19,1154,"#f58181"
"Governor","PM0213",122,113,2,235,"#ffd5d9"
"Governor","PM0214",1001,1056,21,2057,"#d5d9ff"
"Governor","PM0215",587,331,26,918,"#eb4747"
"Governor","PM0216",1073,674,16,1747,"#eb4747"
"Governor","PM0217",1576,975,59,2551,"#eb4747"
"Governor","PM0218",1573,1464,62,3037,"#ffd5d9"
"Governor","PM0219",915,720,51,1635,"#f58181"
"Governor","PM0220",1477,976,35,2453,"#eb4747"
"Governor","PM0221",1083,397,33,1480,"#aa2222"
"Governor","PM0222",775,341,38,1116,"#cc3333"
"Governor","PM0223",475,351,15,826,"#f58181"
"Governor","PM0224",1520,1041,48,2561,"#f58181"
"Governor","PM0225",1484,1291,78,2775,"#ffaaae"
"Governor","PM0226",419,309,8,728,"#f58181"
"Governor","PM0227",1861,1387,76,3248,"#f58181"
"Governor","PM0228",485,486,20,971,"#d5d9ff"
"Governor","PM0229",1950,839,64,2789,"#cc3333"
"Governor","PM0230",346,410,18,756,"#aaaeff"
"Governor","PM0231",1298,1062,58,2360,"#f58181"
"Governor","PM0232",395,464,25,859,"#aaaeff"
"Governor","PM0233",1005,1168,70,2173,"#aaaeff"
"Governor","PM0234",582,710,40,1292,"#aaaeff"
"Governor","PM0235",414,878,36,1292,"#3333cc"
"Governor","PM0236",145,303,26,448,"#3333cc"
"Governor","PM0237",556,760,10,1316,"#8181f5"
"Governor","PM0238",938,1135,14,2073,"#aaaeff"
"Governor","PM0239",1303,1560,24,2863,"#aaaeff"
"Governor","PM0240",79,27,2,106,"#aa2222"
"Governor","PM0241",798,737,19,1535,"#ffd5d9"
"Governor","PM0242",931,672,18,1603,"#f58181"
"Governor","PM0243",954,522,18,1476,"#eb4747"
"Governor","PM0244",76,277,18,353,"#111188"
"Governor","PM0245",216,814,46,1030,"#111188"
"Governor","PM0246",154,1058,26,1212,"#000066"
"Governor","PM0247",40,175,11,215,"#000066"
"Governor","PM0248",98,274,11,372,"#2222aa"
"Governor","PM0249",949,517,42,1466,"#eb4747"
"Governor","PN0001",469,319,30,788,"#f58181"
"Governor","PN0004",156,186,18,342,"#aaaeff"
"Governor","PN0005",658,440,26,1098,"#f58181"
"Governor","PN0006",190,309,17,499,"#4747eb"
"Governor","PN0007",1136,654,38,1790,"#eb4747"
"Governor","PN0008",1565,796,25,2361,"#cc3333"
"Governor","PN0009",791,324,38,1115,"#aa2222"
"Governor","PN0010",902,343,43,1245,"#aa2222"
"Governor","PN0011",117,43,1,160,"#aa2222"
"Governor","PN0012",130,264,20,394,"#3333cc"
"Governor","PN0013",1053,468,29,1521,"#cc3333"
"Governor","PN0014",161,277,21,438,"#4747eb"
"Governor","PN0015",1601,721,8,2322,"#cc3333"
"Governor","PN0016",854,331,22,1185,"#aa2222"
"Governor","PN0017",326,203,26,529,"#eb4747"
"Governor","PN0018",915,536,46,1451,"#eb4747"
"Governor","PN0019",431,279,36,710,"#eb4747"
"Governor","PN0020",339,86,4,425,"#881111"
"Governor","PN0021",403,167,17,570,"#aa2222"
"Governor","PN0022",320,101,10,421,"#881111"
"Governor","PN0023",722,283,25,1005,"#aa2222"
"Governor","PN0024",519,269,33,788,"#cc3333"
"Governor","PN0025",699,152,22,851,"#660000"
"Governor","PN0026",1338,549,37,1887,"#aa2222"
"Governor","PN0027",2505,1147,71,3652,"#cc3333"
"Governor","PN0028",1791,793,39,2584,"#cc3333"
"Governor","PN0029",85,201,11,286,"#2222aa"
"Governor","PN0030",905,652,53,1557,"#f58181"
"Governor","PN0031",155,74,2,229,"#cc3333"
"Governor","PN0032",530,371,41,901,"#f58181"
"Governor","PN0033",570,348,18,918,"#eb4747"
"Governor","PN0034",612,413,31,1025,"#f58181"
"Governor","PN0035",678,441,27,1119,"#eb4747"
"Governor","PN0036",361,407,23,768,"#aaaeff"
"Governor","PN0037",1117,542,39,1659,"#cc3333"
"Governor","PN0038",404,235,12,639,"#eb4747"
"Governor","PN0039",953,497,35,1450,"#cc3333"
"Governor","PN0040",998,461,38,1459,"#cc3333"
"Governor","PN0041",1083,435,27,1518,"#aa2222"
"Governor","PN0042",575,240,19,815,"#aa2222"
"Governor","PN0043",1040,383,26,1423,"#aa2222"
"Governor","PN0044",1026,431,45,1457,"#aa2222"
"Governor","PN0045",976,300,44,1276,"#881111"
"Governor","PN0046",962,300,30,1262,"#881111"
"Governor","PN0047",694,369,43,1063,"#cc3333"
"Governor","PN0048",1026,443,28,1469,"#cc3333"
"Governor","PN0049",299,82,6,381,"#881111"
"Governor","PN0050",337,494,51,831,"#8181f5"
"Governor","PN0051",21,4,0,25,"#660000"
"Governor","PN0052",60,24,1,84,"#aa2222"
"Governor","PN0053",14,88,2,102,"#000066"
"Governor","PN0054",686,225,31,911,"#881111"
"Governor","PN0055",788,383,35,1171,"#cc3333"
"Governor","PN0056",789,299,33,1088,"#aa2222"
"Governor","PN0057",1165,453,24,1618,"#aa2222"
"Governor","PN0058",713,268,21,981,"#aa2222"
"Governor","PN0059",1109,430,48,1539,"#aa2222"
"Governor","PN0060",67,186,10,253,"#2222aa"
"Governor","PN0061",74,147,12,221,"#3333cc"
"Governor","PN0062",62,197,15,259,"#111188"
"Governor","PN0063",516,216,21,732,"#aa2222"
"Governor","PN0064",1446,522,20,1968,"#aa2222"
"Governor","PN0066",920,336,16,1256,"#aa2222"
"Governor","PN0067",495,215,12,710,"#cc3333"
"Governor","PN0068",951,539,26,1490,"#eb4747"
"Governor","PN0069",560,298,23,858,"#cc3333"
"Governor","PN0070",843,417,39,1260,"#cc3333"
"Governor","PN0071",874,340,21,1214,"#aa2222"
"Governor","PN0072",491,206,9,697,"#aa2222"
"Governor","PN0073",541,345,21,886,"#eb4747"
"Governor","PN0074",781,594,41,1375,"#f58181"
"Governor","PN0075",949,506,32,1455,"#cc3333"
"Governor","PN0076",937,373,37,1310,"#aa2222"
"Governor","PN0077",49,134,5,183,"#2222aa"
"Governor","PN0078",872,515,34,1387,"#eb4747"
"Governor","PN0079",951,638,36,1589,"#f58181"
"Governor","PN0080",2013,1170,64,3183,"#eb4747"
"Governor","PN0081",994,528,33,1522,"#cc3333"
"Governor","PN0082",169,196,14,365,"#aaaeff"
"Governor","PN0083",1155,586,42,1741,"#cc3333"
"Governor","PN0084",560,230,13,790,"#aa2222"
"Governor","PN0085",906,447,22,1353,"#cc3333"
"Governor","PN0086",1269,690,50,1959,"#eb4747"
"Governor","PN0087",702,444,29,1146,"#eb4747"
"Governor","PN0088",2596,872,71,3468,"#aa2222"
"Governor","PN0089",1156,454,45,1610,"#aa2222"
"Governor","PN0090",606,526,35,1132,"#ffaaae"
"Governor","PN0091",614,204,29,818,"#881111"
"Governor","PN0092",1879,995,33,2874,"#cc3333"
"Governor","PN0093",469,436,25,905,"#ffd5d9"
"Governor","PN0094",827,448,36,1275,"#eb4747"
"Governor","PN0095",786,343,16,1129,"#cc3333"
"Governor","PN0096",728,280,22,1008,"#aa2222"
"Governor","PN0097",756,441,25,1197,"#eb4747"
"Governor","PN0098",675,312,35,987,"#cc3333"
"Governor","PN0099",889,434,44,1323,"#cc3333"
"Governor","PN0100",620,504,29,1124,"#f58181"
"Governor","PN0101",629,560,35,1189,"#ffaaae"
"Governor","PN0102",946,592,39,1538,"#eb4747"
"Governor","PN0103",0,0,0,0,NA
"Governor","PN0104",95,34,1,129,"#aa2222"
"Governor","PN0105",32,18,4,50,"#eb4747"
"Governor","SC0001",57,195,3,252,"#111188"
"Governor","SC0002",134,425,13,559,"#111188"
"Governor","SC0003",85,268,9,353,"#111188"
"Governor","SC0004",49,139,2,188,"#2222aa"
"Governor","SC0005",197,380,10,577,"#3333cc"
"Governor","SC0006",333,147,5,480,"#cc3333"
"Governor","SC0007",770,961,36,1731,"#8181f5"
"Governor","SC0008",203,751,20,954,"#111188"
"Governor","SC0009",76,99,5,175,"#8181f5"
"Governor","SC0010",118,280,15,398,"#2222aa"
"Governor","SC0011",585,666,19,1251,"#aaaeff"
"Governor","SC0012",52,221,5,273,"#000066"
"Governor","SC0013",81,132,5,213,"#4747eb"
"Governor","SC0014",233,379,13,612,"#4747eb"
"Governor","SC0015",451,223,8,674,"#cc3333"
"Governor","SC0016",62,120,7,182,"#3333cc"
"Governor","SC0017",411,919,28,1330,"#3333cc"
"Governor","SC0018",116,227,7,343,"#3333cc"
"Governor","SC0019",281,700,16,981,"#2222aa"
"Governor","SC0020",119,378,4,497,"#111188"
"Governor","SC0021",251,578,19,829,"#3333cc"
"Governor","SC0022",53,157,5,210,"#2222aa"
"Governor","SC0023",24,14,1,38,"#eb4747"
"Governor","SCNA",51,48,6,99,"#ffd5d9"
"Governor","YA0201",4474,2034,98,6508,"#cc3333"
"Governor","YA0202",2705,1843,105,4548,"#f58181"
"Governor","YA0203",2147,1329,57,3476,"#eb4747"
"Governor","YA0204",3220,2022,101,5242,"#eb4747"
"Governor","YA0205",388,75,5,463,"#660000"
"Governor","YA0206",57,0,0,57,"#660000"
"Governor","YA0207",829,181,14,1010,"#660000"
"Governor","YA0208",427,148,7,575,"#aa2222"
"Governor","YA0209",402,84,6,486,"#660000"
"Governor","YA0210",36,16,1,52,"#cc3333"
"Governor","YA0211",23,5,1,28,"#660000"
"Governor","YA0212",0,0,0,0,NA
"Governor","YA0213",231,73,1,304,"#881111"
"Governor","YA0214",363,92,12,455,"#881111"
"Governor","YA0215",2614,810,52,3424,"#881111"
"Governor","YA0216",1129,702,41,1831,"#eb4747"
"Governor","YA0217",48,34,0,82,"#f58181"
"Governor","YA0218",1300,620,60,1920,"#cc3333"
"Governor","YA0219",3202,1023,102,4225,"#881111"
"Governor","YA0220",16,8,0,24,"#cc3333"
"Governor","YA0221",213,68,5,281,"#881111"
"Governor","YA0222",1703,468,57,2171,"#881111"
"Governor","YA0223",950,223,34,1173,"#660000"
"Governor","YA0224",67,12,0,79,"#660000"
"Governor","YA0225",3675,921,72,4596,"#881111"
"Governor","YA0226",26,18,0,44,"#f58181"
"Governor","YA0227",1850,2611,101,4461,"#8181f5"
"Governor","YA0228",1961,2064,70,4025,"#d5d9ff"
"Governor","YA0229",3420,1963,142,5383,"#eb4747"
"Governor","YA0230",2875,1784,120,4659,"#eb4747"
"Governor","YA0231",224,66,6,290,"#881111"
"Governor","YA0232",924,921,51,1845,"#ffd5d9"
"Governor","YA0233",21,25,2,46,"#aaaeff"
"Governor","YA0234",4844,1903,110,6747,"#aa2222"
"Governor","YA0235",2845,727,37,3572,"#881111"
"Governor","YA0236",363,83,10,446,"#660000"
"Governor","YA0237",3554,734,70,4288,"#660000"
"Governor","YA0238",4250,927,75,5177,"#660000"
"Governor","YA0239",1720,276,26,1996,"#660000"
"Governor","YA0240",458,107,6,565,"#660000"
"Governor","YA0241",318,83,13,401,"#881111"
"Governor","YA0242",3063,1146,56,4209,"#aa2222"
"Governor","YA0243",4186,1371,81,5557,"#881111"
"Governor","YA0244",4636,1649,136,6285,"#aa2222"
"Governor","YA0245",2391,910,86,3301,"#aa2222"
"Governor","YU0001",164,286,10,450,"#4747eb"
"Governor","YU0002",232,321,18,553,"#8181f5"
"Governor","YU0003",224,295,12,519,"#8181f5"
"Governor","YU0004",716,967,36,1683,"#8181f5"
"Governor","YU0005",808,387,13,1195,"#cc3333"
"Governor","YU0006",301,696,24,997,"#3333cc"
"Governor","YU0007",210,1060,48,1270,"#000066"
"Governor","YU0008",568,198,7,766,"#aa2222"
"Governor","YU0009",909,242,8,1151,"#881111"
"Governor","YU0010",1490,682,35,2172,"#cc3333"
"Governor","YU0011",767,437,26,1204,"#eb4747"
"Governor","YU0012",913,317,11,1230,"#aa2222"
"Governor","YU0013",348,387,18,735,"#aaaeff"
"Governor","YU0014",163,107,10,270,"#eb4747"
"Governor","YU0015",831,488,29,1319,"#eb4747"
"Governor","YU0016",536,413,22,949,"#f58181"
"Governor","YU0017",1275,511,32,1786,"#aa2222"
"Governor","YU0018",108,19,2,127,"#660000"
"Governor","YU0019",48,29,3,77,"#eb4747"
"Governor","YU0020",983,332,20,1315,"#aa2222"
"Governor","YU0021",15,3,1,18,"#660000"
"Governor","YU0022",990,430,25,1420,"#cc3333"
"Governor","YU0023",1002,350,16,1352,"#aa2222"
"Governor","YU0024",2709,689,46,3398,"#881111"
"Governor","YU0025",1461,460,10,1921,"#881111"
"Governor","YU0026",98,175,6,273,"#4747eb"
"Governor","YU0027",275,194,10,469,"#f58181"
"Governor","YU0028",113,187,8,300,"#4747eb"
"Governor","YU0029",105,1176,38,1281,"#000066"
"Governor","YU0030",103,1127,23,1230,"#000066"
"Governor","YU0031",184,1422,42,1606,"#000066"
"Governor","YU0032",209,352,17,561,"#4747eb"
"Governor","YU0033",203,133,6,336,"#eb4747"
"Governor","YU0034",314,97,8,411,"#881111"
"Governor","YU0035",561,402,17,963,"#f58181"
"Governor","YU0036",610,528,24,1138,"#ffaaae"
"Governor","YU0037",340,526,26,866,"#4747eb"
"Governor","YU0038",500,493,30,993,"#ffd5d9"
"Governor","YU0039",630,437,23,1067,"#f58181"
"Governor","YU0040",607,489,23,1096,"#f58181"
"Governor","YU0041",704,535,32,1239,"#f58181"
"Governor","YU0042",619,688,29,1307,"#aaaeff"
"Governor","YU0043",12,10,2,22,"#ffaaae"
"Governor","YU0044",0,0,0,0,NA
