contestLongName,Pctcd,"Green, Angela","McSally, Martha","Sinema, Kyrsten",total,color
U.S. Senator,AP0002,7,202,81,290,#aa2222
U.S. Senator,AP0003,68,217,1292,1577,#000066
U.S. Senator,AP0005,39,112,601,752,#000066
U.S. Senator,AP0009,38,1002,298,1338,#881111
U.S. Senator,AP0010,10,46,314,370,#000066
U.S. Senator,AP0011,21,76,559,656,#000066
U.S. Senator,AP0012,21,531,85,637,#660000
U.S. Senator,AP0013,24,71,390,485,#000066
U.S. Senator,AP0016,23,679,142,844,#660000
U.S. Senator,AP0017,9,486,108,603,#660000
U.S. Senator,AP0019,66,275,1251,1592,#000066
U.S. Senator,AP0022,15,40,293,348,#000066
U.S. Senator,AP0023,22,67,430,519,#000066
U.S. Senator,AP0025,2,84,41,127,#cc3333
U.S. Senator,AP0027,27,98,408,533,#111188
U.S. Senator,AP0029,25,57,482,564,#000066
U.S. Senator,AP0031,23,55,346,424,#000066
U.S. Senator,AP0033,35,55,668,758,#000066
U.S. Senator,AP0035,13,55,244,312,#000066
U.S. Senator,AP0037,4,12,58,74,#000066
U.S. Senator,AP0039,24,66,620,710,#000066
U.S. Senator,AP0041,5,7,57,69,#000066
U.S. Senator,AP0043,13,58,398,469,#000066
U.S. Senator,AP0045,6,177,78,261,#cc3333
U.S. Senator,AP0046,5,32,214,251,#000066
U.S. Senator,AP0048,51,202,481,734,#3333cc
U.S. Senator,AP0051,5,19,75,99,#111188
U.S. Senator,AP0052,18,75,238,331,#2222aa
U.S. Senator,AP0054,15,66,540,621,#000066
U.S. Senator,AP0056,14,50,322,386,#000066
U.S. Senator,AP0058,11,43,390,444,#000066
U.S. Senator,AP0059,13,398,88,499,#660000
U.S. Senator,AP0061,25,608,213,846,#aa2222
U.S. Senator,AP0065,45,141,850,1036,#000066
U.S. Senator,AP0067,19,37,336,392,#000066
U.S. Senator,AP0070,17,448,185,650,#aa2222
U.S. Senator,AP0074,22,45,539,606,#000066
U.S. Senator,AP0076,9,53,243,305,#000066
U.S. Senator,AP0078,8,33,207,248,#000066
U.S. Senator,AP0080,15,52,261,328,#000066
U.S. Senator,AP0082,32,764,224,1020,#881111
U.S. Senator,AP0084,38,55,656,749,#000066
U.S. Senator,AP0086,18,36,320,374,#000066
U.S. Senator,AP0088,41,125,672,838,#000066
U.S. Senator,CH0001,30,652,333,1015,#cc3333
U.S. Senator,CH0002,41,892,363,1296,#aa2222
U.S. Senator,CH0003,42,706,393,1141,#eb4747
U.S. Senator,CH0004,21,166,752,939,#000066
U.S. Senator,CH0005,27,355,498,880,#8181f5
U.S. Senator,CH0006,33,303,633,969,#3333cc
U.S. Senator,CH0007,8,105,55,168,#eb4747
U.S. Senator,CH0008,38,803,326,1167,#aa2222
U.S. Senator,CH0009,21,119,534,674,#000066
U.S. Senator,CH0010,35,296,710,1041,#3333cc
U.S. Senator,CH0011,32,109,646,787,#000066
U.S. Senator,CH0012,17,101,463,581,#000066
U.S. Senator,CH0013,23,239,446,708,#4747eb
U.S. Senator,CH0014,39,833,329,1201,#aa2222
U.S. Senator,CH0015,16,923,416,1355,#cc3333
U.S. Senator,CH0016,28,320,228,576,#f58181
U.S. Senator,CH0017,11,432,184,627,#cc3333
U.S. Senator,CH0018,14,94,210,318,#3333cc
U.S. Senator,CH0019,20,563,255,838,#cc3333
U.S. Senator,CH0020,13,208,385,606,#4747eb
U.S. Senator,CH0021,13,503,225,741,#cc3333
U.S. Senator,CH0022,3,126,104,233,#ffaaae
U.S. Senator,CH0023,5,118,28,151,#881111
U.S. Senator,CH0024,21,987,302,1310,#881111
U.S. Senator,CH0025,11,216,103,330,#cc3333
U.S. Senator,CH0026,27,840,494,1361,#eb4747
U.S. Senator,CH0027,38,1177,650,1865,#eb4747
U.S. Senator,CH0028,27,521,385,933,#f58181
U.S. Senator,CH0029,27,389,270,686,#f58181
U.S. Senator,CH0030,24,301,212,537,#f58181
U.S. Senator,CH0031,37,634,387,1058,#eb4747
U.S. Senator,CH0032,23,1184,524,1731,#cc3333
U.S. Senator,CH0033,29,713,382,1124,#eb4747
U.S. Senator,CH0034,34,528,359,921,#f58181
U.S. Senator,CH0035,33,886,324,1243,#aa2222
U.S. Senator,CH0036,22,510,340,872,#f58181
U.S. Senator,CH0037,22,754,298,1074,#aa2222
U.S. Senator,CH0038,21,422,283,726,#f58181
U.S. Senator,CH0039,39,569,514,1122,#ffd5d9
U.S. Senator,CH0040,24,941,378,1343,#aa2222
U.S. Senator,CH0041,37,1030,518,1585,#cc3333
U.S. Senator,CH0042,32,562,356,950,#eb4747
U.S. Senator,CH0043,21,1184,464,1669,#aa2222
U.S. Senator,CH0044,35,787,284,1106,#aa2222
U.S. Senator,CH0045,11,265,110,386,#aa2222
U.S. Senator,CH0046,39,1017,355,1411,#aa2222
U.S. Senator,CH0047,14,616,238,868,#aa2222
U.S. Senator,CH0048,12,572,165,749,#881111
U.S. Senator,CH0049,22,358,172,552,#cc3333
U.S. Senator,CN0001,37,220,921,1178,#111188
U.S. Senator,CN0002,38,170,874,1082,#000066
U.S. Senator,CN0003,19,90,712,821,#000066
U.S. Senator,CN0004,27,354,974,1355,#2222aa
U.S. Senator,CN0005,23,516,1152,1691,#3333cc
U.S. Senator,CN0006,31,385,707,1123,#4747eb
U.S. Senator,CN0007,26,327,664,1017,#3333cc
U.S. Senator,CN0008,14,176,519,709,#2222aa
U.S. Senator,CN0009,41,226,697,964,#2222aa
U.S. Senator,CN0010,23,58,283,364,#000066
U.S. Senator,CN0011,26,129,429,584,#111188
U.S. Senator,CN0012,28,99,609,736,#000066
U.S. Senator,CN0013,21,84,352,457,#111188
U.S. Senator,CN0014,35,156,662,853,#111188
U.S. Senator,CN0015,88,435,1236,1759,#2222aa
U.S. Senator,CN0016,40,398,1001,1439,#2222aa
U.S. Senator,CN0017,16,145,266,427,#4747eb
U.S. Senator,CN0018,20,191,314,525,#4747eb
U.S. Senator,CN0019,37,473,805,1315,#4747eb
U.S. Senator,CN0020,28,91,410,529,#000066
U.S. Senator,CN0021,39,599,1114,1752,#4747eb
U.S. Senator,CN0022,46,793,1268,2107,#4747eb
U.S. Senator,CN0023,54,288,661,1003,#3333cc
U.S. Senator,CN0024,48,816,1103,1967,#8181f5
U.S. Senator,CN0025,37,486,852,1375,#4747eb
U.S. Senator,CN0026,37,261,336,634,#8181f5
U.S. Senator,CN0040,12,199,158,369,#f58181
U.S. Senator,CN0041,10,328,115,453,#aa2222
U.S. Senator,CN0042,26,98,460,584,#000066
U.S. Senator,CN0043,26,101,467,594,#000066
U.S. Senator,CN0047,12,47,266,325,#000066
U.S. Senator,CN0048,6,13,159,178,#000066
U.S. Senator,CN0050,33,764,621,1418,#f58181
U.S. Senator,CN0051,1,27,24,52,#ffaaae
U.S. Senator,CN0052,30,749,589,1368,#f58181
U.S. Senator,CN0053,3,92,41,136,#cc3333
U.S. Senator,CN0055,3,109,168,280,#4747eb
U.S. Senator,CN0056,9,246,296,551,#aaaeff
U.S. Senator,CN0058,16,320,82,418,#881111
U.S. Senator,CN0059,20,101,399,520,#111188
U.S. Senator,CN0060,2,5,33,40,#000066
U.S. Senator,CN0061,20,92,223,335,#3333cc
U.S. Senator,CN0062,58,788,1334,2180,#4747eb
U.S. Senator,CN0063,2,92,54,148,#eb4747
U.S. Senator,CN0064,0,6,1,7,#660000
U.S. Senator,CN0065,31,96,530,657,#000066
U.S. Senator,CN0066,16,250,107,373,#cc3333
U.S. Senator,CN0067,26,111,362,499,#111188
U.S. Senator,CN0069,20,114,566,700,#000066
U.S. Senator,CN0070,6,25,129,160,#000066
U.S. Senator,CN0071,5,17,61,83,#111188
U.S. Senator,CN0072,27,296,265,588,#ffaaae
U.S. Senator,CN0073,24,371,225,620,#eb4747
U.S. Senator,CN0074,24,171,233,428,#8181f5
U.S. Senator,CN0075,33,447,313,793,#f58181
U.S. Senator,CN0079,21,495,241,757,#cc3333
U.S. Senator,CN0080,11,342,284,637,#ffaaae
U.S. Senator,CN0082,9,265,414,688,#4747eb
U.S. Senator,CN0083,21,494,713,1228,#8181f5
U.S. Senator,CN0084,6,210,148,364,#f58181
U.S. Senator,CN0085,34,684,545,1263,#f58181
U.S. Senator,CN0086,3,89,71,163,#f58181
U.S. Senator,CN0088,5,31,206,242,#000066
U.S. Senator,CN0090,51,105,854,1010,#000066
U.S. Senator,CN0092,40,582,590,1212,#d5d9ff
U.S. Senator,CN0093,13,65,454,532,#000066
U.S. Senator,CN0094,13,37,351,401,#000066
U.S. Senator,CN0095,75,219,1353,1647,#000066
U.S. Senator,CN0097,14,221,164,399,#f58181
U.S. Senator,CN0098,44,1006,425,1475,#cc3333
U.S. Senator,CN0099,17,363,225,605,#eb4747
U.S. Senator,GI0100,11,202,144,357,#f58181
U.S. Senator,GI0105,9,62,79,150,#8181f5
U.S. Senator,GI0110,5,27,50,82,#4747eb
U.S. Senator,GI0115,23,159,206,388,#8181f5
U.S. Senator,GI0120,28,279,232,539,#ffaaae
U.S. Senator,GI0125,12,148,132,292,#ffaaae
U.S. Senator,GI0130,16,113,196,325,#4747eb
U.S. Senator,GI0135,17,285,165,467,#eb4747
U.S. Senator,GI0140,10,284,222,516,#f58181
U.S. Senator,GI0150,11,111,123,245,#d5d9ff
U.S. Senator,GI0155,21,84,208,313,#3333cc
U.S. Senator,GI0160,17,263,180,460,#f58181
U.S. Senator,GI0165,10,205,191,406,#ffd5d9
U.S. Senator,GI0170,17,102,138,257,#8181f5
U.S. Senator,GI0175,15,119,109,243,#ffd5d9
U.S. Senator,GI0180,6,84,80,170,#ffd5d9
U.S. Senator,GI0185,6,44,35,85,#f58181
U.S. Senator,GI0200,15,502,214,731,#cc3333
U.S. Senator,GI0205,33,898,348,1279,#aa2222
U.S. Senator,GI0210,43,1329,584,1956,#cc3333
U.S. Senator,GI0215,26,455,251,732,#eb4747
U.S. Senator,GI0220,37,767,342,1146,#cc3333
U.S. Senator,GI0225,24,467,226,717,#cc3333
U.S. Senator,GI0230,18,379,169,566,#cc3333
U.S. Senator,GI0235,38,590,272,900,#cc3333
U.S. Senator,GI0240,29,1159,431,1619,#aa2222
U.S. Senator,GI0300,17,93,297,407,#111188
U.S. Senator,GI0305,12,215,83,310,#aa2222
U.S. Senator,GI0310,13,291,128,432,#cc3333
U.S. Senator,GI0315,39,820,390,1249,#cc3333
U.S. Senator,GI0320,3,103,34,140,#aa2222
U.S. Senator,GI0325,4,66,21,91,#aa2222
U.S. Senator,GI0330,21,627,207,855,#aa2222
U.S. Senator,GI0335,3,122,53,178,#cc3333
U.S. Senator,GI0340,12,315,62,389,#660000
U.S. Senator,GI0345,4,262,137,403,#cc3333
U.S. Senator,GI0400,6,21,212,239,#000066
U.S. Senator,GI0405,0,0,14,14,#000066
U.S. Senator,GI0410,43,128,678,849,#000066
U.S. Senator,GM0001,25,351,227,603,#eb4747
U.S. Senator,GM0002,37,457,301,795,#f58181
U.S. Senator,GM0003,8,256,115,379,#cc3333
U.S. Senator,GM0004,15,181,140,336,#f58181
U.S. Senator,GM0005,25,515,290,830,#eb4747
U.S. Senator,GM0006,3,412,86,501,#660000
U.S. Senator,GM0007,44,783,245,1072,#881111
U.S. Senator,GM0008,8,298,41,347,#660000
U.S. Senator,GM0009,54,1061,268,1383,#881111
U.S. Senator,GM0010,7,150,28,185,#660000
U.S. Senator,GM0011,17,57,509,583,#000066
U.S. Senator,GM0012,3,28,14,45,#cc3333
U.S. Senator,GM0013,1,103,11,115,#660000
U.S. Senator,GM0014,6,147,43,196,#881111
U.S. Senator,GM0015,35,505,386,926,#f58181
U.S. Senator,GM0016,13,32,211,256,#000066
U.S. Senator,GM0017,4,100,36,140,#aa2222
U.S. Senator,GM0018,12,557,168,737,#881111
U.S. Senator,GM0019,26,489,142,657,#881111
U.S. Senator,GM0020,15,332,88,435,#881111
U.S. Senator,GM0021,2,45,12,59,#881111
U.S. Senator,GM0022,3,11,7,21,#f58181
U.S. Senator,GN0001,0,14,0,14,#660000
U.S. Senator,GN0002,0,29,4,33,#660000
U.S. Senator,GN0003,20,161,274,455,#4747eb
U.S. Senator,GN0004,11,148,185,344,#8181f5
U.S. Senator,GN0005,21,316,195,532,#eb4747
U.S. Senator,GN0006,7,84,57,148,#f58181
U.S. Senator,GN0007,24,277,164,465,#eb4747
U.S. Senator,GN0008,25,387,163,575,#cc3333
U.S. Senator,LP0051,56,701,652,1409,#ffd5d9
U.S. Senator,LP0052,7,40,110,157,#2222aa
U.S. Senator,LP0054,27,789,248,1064,#881111
U.S. Senator,LP0055,14,246,65,325,#881111
U.S. Senator,LP0056,4,61,33,98,#eb4747
U.S. Senator,LP0057,18,433,154,605,#aa2222
U.S. Senator,LP0058,44,458,180,682,#aa2222
U.S. Senator,LP0059,1,44,13,58,#881111
U.S. Senator,LP0060,8,161,44,213,#881111
U.S. Senator,LP0062,3,119,32,154,#881111
U.S. Senator,LP0064,17,213,78,308,#aa2222
U.S. Senator,MC0001,84,891,1209,2184,#8181f5
U.S. Senator,MC0002,36,1305,757,2098,#eb4747
U.S. Senator,MC0003,52,167,1032,1251,#000066
U.S. Senator,MC0004,33,758,590,1381,#f58181
U.S. Senator,MC0005,64,2471,1807,4342,#f58181
U.S. Senator,MC0006,31,593,477,1101,#f58181
U.S. Senator,MC0007,9,151,59,219,#aa2222
U.S. Senator,MC0008,47,1174,1683,2904,#8181f5
U.S. Senator,MC0009,42,577,738,1357,#8181f5
U.S. Senator,MC0010,52,736,1290,2078,#4747eb
U.S. Senator,MC0011,35,1612,2295,3942,#8181f5
U.S. Senator,MC0012,21,117,367,505,#2222aa
U.S. Senator,MC0013,18,833,601,1452,#f58181
U.S. Senator,MC0014,9,244,160,413,#eb4747
U.S. Senator,MC0015,24,606,364,994,#eb4747
U.S. Senator,MC0016,27,283,556,866,#3333cc
U.S. Senator,MC0017,27,541,664,1232,#aaaeff
U.S. Senator,MC0018,26,585,648,1259,#aaaeff
U.S. Senator,MC0019,37,609,866,1512,#8181f5
U.S. Senator,MC0020,42,1532,1327,2901,#ffaaae
U.S. Senator,MC0021,41,1027,1063,2131,#d5d9ff
U.S. Senator,MC0022,29,493,376,898,#f58181
U.S. Senator,MC0023,31,762,595,1388,#f58181
U.S. Senator,MC0024,88,1961,1350,3399,#f58181
U.S. Senator,MC0025,56,1976,1880,3912,#ffd5d9
U.S. Senator,MC0026,45,1793,847,2685,#cc3333
U.S. Senator,MC0027,35,833,1344,2212,#4747eb
U.S. Senator,MC0028,52,496,1664,2212,#111188
U.S. Senator,MC0029,3,100,27,130,#881111
U.S. Senator,MC0030,16,757,633,1406,#ffaaae
U.S. Senator,MC0031,49,886,923,1858,#d5d9ff
U.S. Senator,MC0032,37,938,770,1745,#ffaaae
U.S. Senator,MC0033,45,820,804,1669,#ffd5d9
U.S. Senator,MC0034,24,242,422,688,#4747eb
U.S. Senator,MC0035,37,1181,864,2082,#f58181
U.S. Senator,MC0036,25,1392,1373,2790,#ffd5d9
U.S. Senator,MC0037,30,162,567,759,#111188
U.S. Senator,MC0038,96,1308,1174,2578,#ffaaae
U.S. Senator,MC0039,59,679,1575,2313,#3333cc
U.S. Senator,MC0040,65,327,1362,1754,#111188
U.S. Senator,MC0041,19,635,863,1517,#8181f5
U.S. Senator,MC0042,74,1961,1943,3978,#ffd5d9
U.S. Senator,MC0043,46,1939,1358,3343,#f58181
U.S. Senator,MC0044,26,520,591,1137,#aaaeff
U.S. Senator,MC0045,15,552,741,1308,#8181f5
U.S. Senator,MC0046,16,106,268,390,#2222aa
U.S. Senator,MC0047,24,75,506,605,#000066
U.S. Senator,MC0048,19,904,1048,1971,#aaaeff
U.S. Senator,MC0049,24,1198,609,1831,#cc3333
U.S. Senator,MC0050,119,902,1541,2562,#4747eb
U.S. Senator,MC0051,26,1270,839,2135,#eb4747
U.S. Senator,MC0052,64,823,888,1775,#d5d9ff
U.S. Senator,MC0053,50,667,487,1204,#f58181
U.S. Senator,MC0054,17,527,309,853,#eb4747
U.S. Senator,MC0055,108,1356,1717,3181,#8181f5
U.S. Senator,MC0056,54,959,910,1923,#ffd5d9
U.S. Senator,MC0057,26,889,601,1516,#f58181
U.S. Senator,MC0058,30,55,206,291,#111188
U.S. Senator,MC0059,30,1162,831,2023,#f58181
U.S. Senator,MC0060,21,1597,1081,2699,#f58181
U.S. Senator,MC0061,68,2422,1521,4011,#eb4747
U.S. Senator,MC0062,36,420,376,832,#ffaaae
U.S. Senator,MC0063,46,478,797,1321,#4747eb
U.S. Senator,MC0064,68,1132,1255,2455,#aaaeff
U.S. Senator,MC0065,4,53,45,102,#ffaaae
U.S. Senator,MC0066,33,705,671,1409,#ffd5d9
U.S. Senator,MC0067,10,121,90,221,#f58181
U.S. Senator,MC0068,34,257,977,1268,#111188
U.S. Senator,MC0069,110,1282,1870,3262,#8181f5
U.S. Senator,MC0070,13,1187,902,2102,#f58181
U.S. Senator,MC0071,27,517,1391,1935,#2222aa
U.S. Senator,MC0072,31,456,476,963,#d5d9ff
U.S. Senator,MC0073,13,515,751,1279,#8181f5
U.S. Senator,MC0074,50,1097,887,2034,#f58181
U.S. Senator,MC0075,10,47,264,321,#000066
U.S. Senator,MC0076,34,1777,1928,3739,#d5d9ff
U.S. Senator,MC0077,50,1439,1036,2525,#f58181
U.S. Senator,MC0078,41,1609,890,2540,#eb4747
U.S. Senator,MC0079,17,426,765,1208,#4747eb
U.S. Senator,MC0080,56,2185,1068,3309,#cc3333
U.S. Senator,MC0081,38,1020,1131,2189,#aaaeff
U.S. Senator,MC0082,0,122,83,205,#f58181
U.S. Senator,MC0083,65,1284,923,2272,#f58181
U.S. Senator,MC0084,34,272,884,1190,#111188
U.S. Senator,MC0085,31,1016,1458,2505,#8181f5
U.S. Senator,MC0086,21,1618,889,2528,#eb4747
U.S. Senator,MC0087,76,325,1119,1520,#111188
U.S. Senator,MC0088,56,514,918,1488,#4747eb
U.S. Senator,MC0089,94,1190,1030,2314,#ffaaae
U.S. Senator,MC0090,35,699,841,1575,#aaaeff
U.S. Senator,MC0091,58,773,1160,1991,#8181f5
U.S. Senator,MC0092,64,570,1400,2034,#2222aa
U.S. Senator,MC0093,82,554,1981,2617,#111188
U.S. Senator,MC0094,24,1177,763,1964,#eb4747
U.S. Senator,MC0095,51,1470,1475,2996,#d5d9ff
U.S. Senator,MC0096,26,1609,963,2598,#eb4747
U.S. Senator,MC0097,48,482,1308,1838,#2222aa
U.S. Senator,MC0098,35,477,594,1106,#8181f5
U.S. Senator,MC0099,44,363,1318,1725,#111188
U.S. Senator,MC0100,55,244,792,1091,#111188
U.S. Senator,MC0101,52,2154,1498,3704,#f58181
U.S. Senator,MC0102,22,80,491,593,#000066
U.S. Senator,MC0103,89,608,2145,2842,#111188
U.S. Senator,MC0104,16,1586,897,2499,#eb4747
U.S. Senator,MC0105,33,425,671,1129,#4747eb
U.S. Senator,MC0106,81,747,1107,1935,#8181f5
U.S. Senator,MC0107,27,498,519,1044,#d5d9ff
U.S. Senator,MC0108,23,1277,1163,2463,#ffd5d9
U.S. Senator,MC0109,37,837,856,1730,#d5d9ff
U.S. Senator,MC0110,27,527,1167,1721,#3333cc
U.S. Senator,MC0111,44,951,963,1958,#d5d9ff
U.S. Senator,MC0112,86,1310,1086,2482,#ffaaae
U.S. Senator,MC0113,5,294,155,454,#cc3333
U.S. Senator,MC0114,39,1187,1205,2431,#d5d9ff
U.S. Senator,MC0115,3,583,392,978,#f58181
U.S. Senator,MC0116,13,327,642,982,#3333cc
U.S. Senator,MC0117,45,1310,901,2256,#f58181
U.S. Senator,MC0118,31,267,337,635,#8181f5
U.S. Senator,MC0119,44,1683,1890,3617,#aaaeff
U.S. Senator,MC0120,20,769,627,1416,#f58181
U.S. Senator,MC0121,64,464,1174,1702,#2222aa
U.S. Senator,MC0122,70,1702,1967,3739,#aaaeff
U.S. Senator,MC0123,27,633,1391,2051,#3333cc
U.S. Senator,MC0124,41,187,589,817,#2222aa
U.S. Senator,MC0125,73,1036,945,2054,#ffd5d9
U.S. Senator,MC0126,35,300,721,1056,#3333cc
U.S. Senator,MC0127,43,1710,1842,3595,#d5d9ff
U.S. Senator,MC0128,35,556,718,1309,#8181f5
U.S. Senator,MC0129,31,521,672,1224,#8181f5
U.S. Senator,MC0130,23,670,418,1111,#eb4747
U.S. Senator,MC0131,30,412,524,966,#8181f5
U.S. Senator,MC0132,17,1086,958,2061,#ffaaae
U.S. Senator,MC0133,32,458,532,1022,#aaaeff
U.S. Senator,MC0134,27,116,476,619,#111188
U.S. Senator,MC0135,42,1066,1797,2905,#4747eb
U.S. Senator,MC0136,18,146,476,640,#111188
U.S. Senator,MC0137,48,435,921,1404,#3333cc
U.S. Senator,MC0138,20,144,371,535,#2222aa
U.S. Senator,MC0139,15,488,755,1258,#4747eb
U.S. Senator,MC0140,57,876,1311,2244,#8181f5
U.S. Senator,MC0141,45,1297,815,2157,#eb4747
U.S. Senator,MC0142,32,258,435,725,#4747eb
U.S. Senator,MC0143,66,1457,1253,2776,#ffaaae
U.S. Senator,MC0144,61,2061,1496,3618,#f58181
U.S. Senator,MC0145,27,387,340,754,#ffaaae
U.S. Senator,MC0146,17,229,273,519,#aaaeff
U.S. Senator,MC0147,45,1284,782,2111,#eb4747
U.S. Senator,MC0148,40,638,609,1287,#ffd5d9
U.S. Senator,MC0149,44,1598,834,2476,#cc3333
U.S. Senator,MC0150,43,818,619,1480,#f58181
U.S. Senator,MC0151,55,1544,1140,2739,#f58181
U.S. Senator,MC0152,47,378,1340,1765,#111188
U.S. Senator,MC0153,12,615,355,982,#eb4747
U.S. Senator,MC0154,68,1335,1737,3140,#8181f5
U.S. Senator,MC0155,47,681,497,1225,#f58181
U.S. Senator,MC0156,24,487,440,951,#ffd5d9
U.S. Senator,MC0157,79,1920,1587,3586,#ffaaae
U.S. Senator,MC0158,90,959,1763,2812,#4747eb
U.S. Senator,MC0159,38,710,802,1550,#aaaeff
U.S. Senator,MC0160,21,142,671,834,#000066
U.S. Senator,MC0161,39,646,505,1190,#f58181
U.S. Senator,MC0162,45,547,554,1146,#d5d9ff
U.S. Senator,MC0163,86,1224,932,2242,#f58181
U.S. Senator,MC0164,53,1009,770,1832,#f58181
U.S. Senator,MC0165,62,415,1082,1559,#2222aa
U.S. Senator,MC0166,31,293,940,1264,#111188
U.S. Senator,MC0167,53,2670,2098,4821,#f58181
U.S. Senator,MC0168,38,2284,785,3107,#aa2222
U.S. Senator,MC0169,52,971,710,1733,#f58181
U.S. Senator,MC0170,14,296,366,676,#8181f5
U.S. Senator,MC0171,25,1339,1202,2566,#ffaaae
U.S. Senator,MC0172,39,846,1339,2224,#4747eb
U.S. Senator,MC0173,58,749,1102,1909,#8181f5
U.S. Senator,MC0174,19,730,532,1281,#f58181
U.S. Senator,MC0175,36,557,956,1549,#4747eb
U.S. Senator,MC0176,81,1163,1319,2563,#aaaeff
U.S. Senator,MC0177,52,1696,1350,3098,#f58181
U.S. Senator,MC0178,62,1894,1328,3284,#f58181
U.S. Senator,MC0179,11,1468,698,2177,#cc3333
U.S. Senator,MC0180,27,1858,746,2631,#aa2222
U.S. Senator,MC0181,52,652,837,1541,#8181f5
U.S. Senator,MC0182,86,2073,1023,3182,#cc3333
U.S. Senator,MC0183,60,2405,1701,4166,#f58181
U.S. Senator,MC0184,53,201,885,1139,#000066
U.S. Senator,MC0185,69,1249,1542,2860,#8181f5
U.S. Senator,MC0186,26,651,710,1387,#d5d9ff
U.S. Senator,MC0187,27,506,650,1183,#8181f5
U.S. Senator,MC0188,44,202,815,1061,#111188
U.S. Senator,MC0189,71,1311,1866,3248,#8181f5
U.S. Senator,MC0190,35,381,778,1194,#3333cc
U.S. Senator,MC0191,75,2736,1836,4647,#f58181
U.S. Senator,MC0192,119,1075,2496,3690,#3333cc
U.S. Senator,MC0193,20,657,631,1308,#ffd5d9
U.S. Senator,MC0194,67,1360,1985,3412,#8181f5
U.S. Senator,MC0195,11,1298,940,2249,#f58181
U.S. Senator,MC0196,17,1041,644,1702,#eb4747
U.S. Senator,MC0197,20,365,691,1076,#3333cc
U.S. Senator,MC0198,119,1859,1546,3524,#ffaaae
U.S. Senator,MC0199,45,420,877,1342,#3333cc
U.S. Senator,MC0200,27,933,979,1939,#d5d9ff
U.S. Senator,MC0201,57,1910,1379,3346,#f58181
U.S. Senator,MC0202,46,735,1040,1821,#8181f5
U.S. Senator,MC0203,44,612,946,1602,#4747eb
U.S. Senator,MC0204,32,106,719,857,#000066
U.S. Senator,MC0205,48,694,669,1411,#ffd5d9
U.S. Senator,MC0206,80,3484,1821,5385,#cc3333
U.S. Senator,MC0207,61,396,1120,1577,#2222aa
U.S. Senator,MC0208,28,1394,1153,2575,#ffaaae
U.S. Senator,MC0209,21,364,353,738,#ffd5d9
U.S. Senator,MC0210,17,508,420,945,#ffaaae
U.S. Senator,MC0211,48,922,687,1657,#f58181
U.S. Senator,MC0212,41,330,596,967,#4747eb
U.S. Senator,MC0213,47,132,881,1060,#000066
U.S. Senator,MC0214,70,716,1507,2293,#3333cc
U.S. Senator,MC0215,37,505,1061,1603,#3333cc
U.S. Senator,MC0216,79,753,1312,2144,#4747eb
U.S. Senator,MC0217,31,538,507,1076,#ffd5d9
U.S. Senator,MC0218,80,362,1418,1860,#111188
U.S. Senator,MC0219,41,1065,846,1952,#f58181
U.S. Senator,MC0220,69,989,1345,2403,#8181f5
U.S. Senator,MC0221,40,434,1716,2190,#111188
U.S. Senator,MC0222,61,1341,937,2339,#f58181
U.S. Senator,MC0223,30,1316,673,2019,#cc3333
U.S. Senator,MC0224,53,345,1409,1807,#111188
U.S. Senator,MC0225,32,382,484,898,#8181f5
U.S. Senator,MC0226,81,1743,1525,3349,#ffaaae
U.S. Senator,MC0227,81,561,1393,2035,#2222aa
U.S. Senator,MC0228,64,1866,1616,3546,#ffaaae
U.S. Senator,MC0229,53,561,1657,2271,#2222aa
U.S. Senator,MC0230,17,588,578,1183,#ffd5d9
U.S. Senator,MC0231,49,651,788,1488,#aaaeff
U.S. Senator,MC0232,97,2301,1507,3905,#eb4747
U.S. Senator,MC0233,79,2306,1237,3622,#eb4747
U.S. Senator,MC0234,40,2053,1288,3381,#eb4747
U.S. Senator,MC0235,52,1203,1314,2569,#d5d9ff
U.S. Senator,MC0236,73,1400,2172,3645,#4747eb
U.S. Senator,MC0237,38,1607,1702,3347,#d5d9ff
U.S. Senator,MC0238,5,41,154,200,#111188
U.S. Senator,MC0239,27,1275,835,2137,#eb4747
U.S. Senator,MC0240,47,1648,1241,2936,#f58181
U.S. Senator,MC0241,45,1054,1410,2509,#8181f5
U.S. Senator,MC0242,33,641,646,1320,#d5d9ff
U.S. Senator,MC0243,51,989,633,1673,#eb4747
U.S. Senator,MC0244,63,2068,1424,3555,#f58181
U.S. Senator,MC0245,60,2687,2470,5217,#ffd5d9
U.S. Senator,MC0246,78,1441,2296,3815,#4747eb
U.S. Senator,MC0247,46,533,1159,1738,#3333cc
U.S. Senator,MC0248,17,115,474,606,#111188
U.S. Senator,MC0249,44,150,1212,1406,#000066
U.S. Senator,MC0250,42,1412,867,2321,#eb4747
U.S. Senator,MC0251,60,871,929,1860,#d5d9ff
U.S. Senator,MC0252,23,1129,652,1804,#eb4747
U.S. Senator,MC0253,36,1019,1181,2236,#aaaeff
U.S. Senator,MC0254,29,420,595,1044,#8181f5
U.S. Senator,MC0255,71,848,1422,2341,#4747eb
U.S. Senator,MC0256,12,202,171,385,#ffaaae
U.S. Senator,MC0257,41,1008,962,2011,#ffd5d9
U.S. Senator,MC0258,68,1237,1230,2535,#ffd5d9
U.S. Senator,MC0259,44,589,726,1359,#8181f5
U.S. Senator,MC0260,23,632,990,1645,#4747eb
U.S. Senator,MC0261,20,465,940,1425,#3333cc
U.S. Senator,MC0262,32,1719,778,2529,#cc3333
U.S. Senator,MC0263,23,523,581,1127,#aaaeff
U.S. Senator,MC0264,28,1900,1221,3149,#eb4747
U.S. Senator,MC0265,93,1005,1017,2115,#d5d9ff
U.S. Senator,MC0266,2,129,60,191,#cc3333
U.S. Senator,MC0267,31,259,491,781,#4747eb
U.S. Senator,MC0268,51,316,1089,1456,#111188
U.S. Senator,MC0269,49,2445,1736,4230,#f58181
U.S. Senator,MC0270,57,1806,1342,3205,#f58181
U.S. Senator,MC0271,18,2218,893,3129,#aa2222
U.S. Senator,MC0272,10,1057,706,1773,#f58181
U.S. Senator,MC0273,52,1126,725,1903,#eb4747
U.S. Senator,MC0274,56,153,1013,1222,#000066
U.S. Senator,MC0275,83,1874,1445,3402,#f58181
U.S. Senator,MC0276,66,1114,1184,2364,#d5d9ff
U.S. Senator,MC0277,15,709,444,1168,#eb4747
U.S. Senator,MC0278,60,774,890,1724,#aaaeff
U.S. Senator,MC0279,53,1741,1059,2853,#eb4747
U.S. Senator,MC0280,34,88,1120,1242,#000066
U.S. Senator,MC0281,47,416,943,1406,#3333cc
U.S. Senator,MC0282,32,243,776,1051,#111188
U.S. Senator,MC0283,47,817,1655,2519,#3333cc
U.S. Senator,MC0284,16,402,206,624,#cc3333
U.S. Senator,MC0285,24,1322,762,2108,#eb4747
U.S. Senator,MC0286,74,804,1381,2259,#4747eb
U.S. Senator,MC0287,81,1454,1113,2648,#f58181
U.S. Senator,MC0288,5,53,41,99,#f58181
U.S. Senator,MC0289,13,226,326,565,#8181f5
U.S. Senator,MC0290,17,56,493,566,#000066
U.S. Senator,MC0291,3,59,57,119,#ffd5d9
U.S. Senator,MC0292,37,1304,814,2155,#eb4747
U.S. Senator,MC0293,56,582,923,1561,#4747eb
U.S. Senator,MC0294,63,826,678,1567,#ffaaae
U.S. Senator,MC0295,29,104,745,878,#000066
U.S. Senator,MC0296,83,595,1088,1766,#4747eb
U.S. Senator,MC0297,59,195,1590,1844,#000066
U.S. Senator,MC0298,68,2474,1356,3898,#eb4747
U.S. Senator,MC0299,1,0,25,26,#000066
U.S. Senator,MC0300,79,342,1393,1814,#111188
U.S. Senator,MC0301,53,2116,1326,3495,#eb4747
U.S. Senator,MC0302,85,1967,1456,3508,#f58181
U.S. Senator,MC0303,22,1103,825,1950,#f58181
U.S. Senator,MC0304,30,1052,811,1893,#f58181
U.S. Senator,MC0305,48,1261,1155,2464,#ffd5d9
U.S. Senator,MC0306,12,86,367,465,#000066
U.S. Senator,MC0307,63,657,880,1600,#8181f5
U.S. Senator,MC0308,28,93,455,576,#000066
U.S. Senator,MC0309,72,335,1400,1807,#111188
U.S. Senator,MC0310,60,554,1223,1837,#3333cc
U.S. Senator,MC0311,19,170,672,861,#111188
U.S. Senator,MC0312,46,192,946,1184,#000066
U.S. Senator,MC0313,74,245,1174,1493,#000066
U.S. Senator,MC0314,77,380,990,1447,#2222aa
U.S. Senator,MC0315,53,253,1431,1737,#000066
U.S. Senator,MC0316,55,969,786,1810,#f58181
U.S. Senator,MC0317,16,1070,943,2029,#ffaaae
U.S. Senator,MC0318,36,1727,1550,3313,#ffaaae
U.S. Senator,MC0319,41,1647,1328,3016,#f58181
U.S. Senator,MC0320,20,494,745,1259,#8181f5
U.S. Senator,MC0321,53,320,1291,1664,#111188
U.S. Senator,MC0322,73,613,1169,1855,#4747eb
U.S. Senator,MC0323,62,718,960,1740,#8181f5
U.S. Senator,MC0324,73,521,1365,1959,#2222aa
U.S. Senator,MC0325,54,1324,803,2181,#eb4747
U.S. Senator,MC0326,16,82,488,586,#000066
U.S. Senator,MC0327,77,1988,1850,3915,#ffd5d9
U.S. Senator,MC0328,33,1229,1216,2478,#ffd5d9
U.S. Senator,MC0329,42,563,769,1374,#8181f5
U.S. Senator,MC0330,25,674,389,1088,#eb4747
U.S. Senator,MC0331,42,636,989,1667,#4747eb
U.S. Senator,MC0332,49,587,1349,1985,#3333cc
U.S. Senator,MC0333,35,1268,919,2222,#f58181
U.S. Senator,MC0334,75,1195,1182,2452,#ffd5d9
U.S. Senator,MC0335,25,572,376,973,#eb4747
U.S. Senator,MC0336,56,969,1540,2565,#4747eb
U.S. Senator,MC0337,26,1144,1066,2236,#ffd5d9
U.S. Senator,MC0338,61,794,1471,2326,#4747eb
U.S. Senator,MC0339,19,910,771,1700,#ffaaae
U.S. Senator,MC0340,78,902,1475,2455,#4747eb
U.S. Senator,MC0341,56,493,1145,1694,#3333cc
U.S. Senator,MC0342,50,1768,1253,3071,#f58181
U.S. Senator,MC0343,26,582,434,1042,#f58181
U.S. Senator,MC0344,69,1048,997,2114,#ffd5d9
U.S. Senator,MC0345,3,498,337,838,#f58181
U.S. Senator,MC0346,86,692,1400,2178,#3333cc
U.S. Senator,MC0347,21,585,412,1018,#f58181
U.S. Senator,MC0348,79,1080,1849,3008,#4747eb
U.S. Senator,MC0349,12,19,188,219,#000066
U.S. Senator,MC0350,36,509,679,1224,#8181f5
U.S. Senator,MC0351,44,2245,1494,3783,#f58181
U.S. Senator,MC0352,43,2277,1214,3534,#cc3333
U.S. Senator,MC0353,21,613,450,1084,#f58181
U.S. Senator,MC0354,44,1218,1693,2955,#8181f5
U.S. Senator,MC0355,12,504,711,1227,#8181f5
U.S. Senator,MC0356,42,1762,1791,3595,#d5d9ff
U.S. Senator,MC0357,62,1190,1220,2472,#d5d9ff
U.S. Senator,MC0358,56,1462,1015,2533,#f58181
U.S. Senator,MC0359,31,2233,1281,3545,#eb4747
U.S. Senator,MC0360,72,294,1207,1573,#111188
U.S. Senator,MC0361,20,674,569,1263,#ffaaae
U.S. Senator,MC0362,37,239,945,1221,#111188
U.S. Senator,MC0363,102,707,2226,3035,#111188
U.S. Senator,MC0364,11,192,162,365,#ffaaae
U.S. Senator,MC0365,44,888,483,1415,#eb4747
U.S. Senator,MC0366,30,1086,729,1845,#f58181
U.S. Senator,MC0367,31,131,576,738,#000066
U.S. Senator,MC0368,41,722,561,1324,#f58181
U.S. Senator,MC0369,26,716,467,1209,#eb4747
U.S. Senator,MC0370,48,1017,820,1885,#f58181
U.S. Senator,MC0371,21,612,570,1203,#ffd5d9
U.S. Senator,MC0372,29,1018,728,1775,#f58181
U.S. Senator,MC0373,49,923,994,1966,#d5d9ff
U.S. Senator,MC0374,68,526,1618,2212,#2222aa
U.S. Senator,MC0375,20,992,542,1554,#eb4747
U.S. Senator,MC0376,0,1,6,7,#000066
U.S. Senator,MC0377,55,3140,1823,5018,#eb4747
U.S. Senator,MC0378,45,249,971,1265,#111188
U.S. Senator,MC0379,27,1254,643,1924,#cc3333
U.S. Senator,MC0380,50,1381,1492,2923,#d5d9ff
U.S. Senator,MC0381,34,222,448,704,#3333cc
U.S. Senator,MC0382,24,1077,1122,2223,#d5d9ff
U.S. Senator,MC0383,39,1300,615,1954,#cc3333
U.S. Senator,MC0384,35,1644,1227,2906,#f58181
U.S. Senator,MC0385,23,114,506,643,#000066
U.S. Senator,MC0386,119,1933,1691,3743,#ffaaae
U.S. Senator,MC0387,53,457,1246,1756,#2222aa
U.S. Senator,MC0388,42,627,723,1392,#aaaeff
U.S. Senator,MC0389,52,111,941,1104,#000066
U.S. Senator,MC0390,15,705,842,1562,#aaaeff
U.S. Senator,MC0391,54,532,1903,2489,#111188
U.S. Senator,MC0392,41,170,867,1078,#000066
U.S. Senator,MC0393,31,634,600,1265,#ffd5d9
U.S. Senator,MC0394,69,1428,2226,3723,#4747eb
U.S. Senator,MC0395,34,1390,860,2284,#eb4747
U.S. Senator,MC0396,58,816,812,1686,#ffd5d9
U.S. Senator,MC0397,42,376,785,1203,#3333cc
U.S. Senator,MC0398,26,423,542,991,#8181f5
U.S. Senator,MC0399,43,767,1206,2016,#4747eb
U.S. Senator,MC0400,37,479,650,1166,#8181f5
U.S. Senator,MC0401,44,463,765,1272,#4747eb
U.S. Senator,MC0402,78,283,1207,1568,#111188
U.S. Senator,MC0403,64,793,1706,2563,#3333cc
U.S. Senator,MC0404,48,1022,894,1964,#ffaaae
U.S. Senator,MC0405,21,317,172,510,#eb4747
U.S. Senator,MC0406,39,277,674,990,#2222aa
U.S. Senator,MC0407,38,253,988,1279,#111188
U.S. Senator,MC0408,53,687,1526,2266,#3333cc
U.S. Senator,MC0409,34,276,396,706,#8181f5
U.S. Senator,MC0410,38,2030,2154,4222,#d5d9ff
U.S. Senator,MC0411,12,284,363,659,#8181f5
U.S. Senator,MC0412,28,141,1021,1190,#000066
U.S. Senator,MC0413,53,743,1226,2022,#4747eb
U.S. Senator,MC0414,41,882,1278,2201,#8181f5
U.S. Senator,MC0415,110,2836,2349,5295,#ffaaae
U.S. Senator,MC0416,75,1945,1715,3735,#ffaaae
U.S. Senator,MC0417,26,479,335,840,#f58181
U.S. Senator,MC0418,46,581,678,1305,#aaaeff
U.S. Senator,MC0419,76,1074,1078,2228,#d5d9ff
U.S. Senator,MC0420,83,2318,1532,3933,#f58181
U.S. Senator,MC0421,35,317,589,941,#4747eb
U.S. Senator,MC0422,31,492,416,939,#ffaaae
U.S. Senator,MC0423,62,1583,1119,2764,#f58181
U.S. Senator,MC0424,33,123,536,692,#111188
U.S. Senator,MC0425,56,1460,1731,3247,#aaaeff
U.S. Senator,MC0426,83,906,1273,2262,#8181f5
U.S. Senator,MC0427,32,241,1187,1460,#000066
U.S. Senator,MC0428,0,22,10,32,#cc3333
U.S. Senator,MC0429,46,1122,1309,2477,#aaaeff
U.S. Senator,MC0430,33,695,539,1267,#f58181
U.S. Senator,MC0431,60,294,1110,1464,#111188
U.S. Senator,MC0432,53,1567,1677,3297,#d5d9ff
U.S. Senator,MC0433,30,100,613,743,#000066
U.S. Senator,MC0434,44,203,560,807,#2222aa
U.S. Senator,MC0435,44,1712,1014,2770,#eb4747
U.S. Senator,MC0436,20,1122,924,2066,#ffaaae
U.S. Senator,MC0437,13,392,150,555,#aa2222
U.S. Senator,MC0438,62,1207,1444,2713,#aaaeff
U.S. Senator,MC0439,60,1946,1002,3008,#cc3333
U.S. Senator,MC0440,52,1124,1394,2570,#8181f5
U.S. Senator,MC0441,61,1450,1886,3397,#8181f5
U.S. Senator,MC0442,32,1655,1465,3152,#ffaaae
U.S. Senator,MC0443,60,1264,1303,2627,#d5d9ff
U.S. Senator,MC0444,63,2036,855,2954,#cc3333
U.S. Senator,MC0445,46,486,830,1362,#4747eb
U.S. Senator,MC0446,30,1037,995,2062,#ffd5d9
U.S. Senator,MC0447,59,2469,1935,4463,#f58181
U.S. Senator,MC0448,44,362,1540,1946,#000066
U.S. Senator,MC0449,2,128,226,356,#4747eb
U.S. Senator,MC0450,31,124,326,481,#2222aa
U.S. Senator,MC0451,23,460,745,1228,#4747eb
U.S. Senator,MC0452,11,422,342,775,#f58181
U.S. Senator,MC0453,39,1236,1719,2994,#8181f5
U.S. Senator,MC0454,39,2515,1517,4071,#eb4747
U.S. Senator,MC0455,90,2535,1745,4370,#f58181
U.S. Senator,MC0456,36,229,549,814,#3333cc
U.S. Senator,MC0457,80,792,895,1767,#aaaeff
U.S. Senator,MC0458,50,1056,817,1923,#f58181
U.S. Senator,MC0459,34,535,1101,1670,#3333cc
U.S. Senator,MC0460,24,716,1040,1780,#8181f5
U.S. Senator,MC0461,53,911,1637,2601,#4747eb
U.S. Senator,MC0462,7,570,435,1012,#f58181
U.S. Senator,MC0463,24,428,887,1339,#3333cc
U.S. Senator,MC0464,83,1570,1468,3121,#ffd5d9
U.S. Senator,MC0465,80,702,1421,2203,#3333cc
U.S. Senator,MC0466,73,768,1102,1943,#8181f5
U.S. Senator,MC0467,21,810,616,1447,#f58181
U.S. Senator,MC0468,41,1031,654,1726,#eb4747
U.S. Senator,MC0469,56,737,1408,2201,#3333cc
U.S. Senator,MC0470,26,1379,879,2284,#eb4747
U.S. Senator,MC0471,12,94,100,206,#d5d9ff
U.S. Senator,MC0472,29,798,750,1577,#ffd5d9
U.S. Senator,MC0473,12,354,600,966,#4747eb
U.S. Senator,MC0474,67,893,1355,2315,#8181f5
U.S. Senator,MC0475,46,168,874,1088,#000066
U.S. Senator,MC0476,47,587,1420,2054,#2222aa
U.S. Senator,MC0477,48,1096,928,2072,#ffaaae
U.S. Senator,MC0478,10,1067,743,1820,#f58181
U.S. Senator,MC0479,98,1295,1639,3032,#8181f5
U.S. Senator,MC0480,80,780,1210,2070,#4747eb
U.S. Senator,MC0481,41,216,718,975,#111188
U.S. Senator,MC0482,34,257,1224,1515,#000066
U.S. Senator,MC0483,31,432,311,774,#f58181
U.S. Senator,MC0484,44,730,736,1510,#d5d9ff
U.S. Senator,MC0485,76,569,2570,3215,#000066
U.S. Senator,MC0486,10,609,465,1084,#f58181
U.S. Senator,MC0487,62,1658,1244,2964,#f58181
U.S. Senator,MC0488,56,1338,787,2181,#eb4747
U.S. Senator,MC0489,15,1320,702,2037,#cc3333
U.S. Senator,MC0490,60,3667,2524,6251,#f58181
U.S. Senator,MC0491,33,151,511,695,#111188
U.S. Senator,MC0492,58,1589,1967,3614,#8181f5
U.S. Senator,MC0493,7,17,106,130,#000066
U.S. Senator,MC0494,33,947,609,1589,#eb4747
U.S. Senator,MC0495,38,234,1001,1273,#000066
U.S. Senator,MC0496,24,185,385,594,#3333cc
U.S. Senator,MC0497,46,487,761,1294,#4747eb
U.S. Senator,MC0498,63,431,1254,1748,#2222aa
U.S. Senator,MC0499,35,281,890,1206,#111188
U.S. Senator,MC0500,51,853,613,1517,#f58181
U.S. Senator,MC0501,35,674,948,1657,#8181f5
U.S. Senator,MC0502,21,335,833,1189,#2222aa
U.S. Senator,MC0503,93,1387,1486,2966,#d5d9ff
U.S. Senator,MC0504,34,877,1108,2019,#8181f5
U.S. Senator,MC0505,25,1325,1014,2364,#f58181
U.S. Senator,MC0506,34,3559,1713,5306,#cc3333
U.S. Senator,MC0507,17,1241,876,2134,#f58181
U.S. Senator,MC0508,74,1222,1435,2731,#aaaeff
U.S. Senator,MC0509,22,1248,1211,2481,#ffd5d9
U.S. Senator,MC0510,33,668,529,1230,#f58181
U.S. Senator,MC0511,55,1227,1041,2323,#ffaaae
U.S. Senator,MC0512,29,1171,626,1826,#eb4747
U.S. Senator,MC0513,16,362,346,724,#ffd5d9
U.S. Senator,MC0514,32,456,601,1089,#8181f5
U.S. Senator,MC0515,41,597,838,1476,#8181f5
U.S. Senator,MC0516,66,824,679,1569,#ffaaae
U.S. Senator,MC0517,64,1591,1208,2863,#f58181
U.S. Senator,MC0518,65,1825,1444,3334,#f58181
U.S. Senator,MC0519,62,938,1672,2672,#4747eb
U.S. Senator,MC0520,70,903,1190,2163,#8181f5
U.S. Senator,MC0521,91,3184,2274,5549,#f58181
U.S. Senator,MC0522,59,1679,1808,3546,#d5d9ff
U.S. Senator,MC0523,50,1699,673,2422,#aa2222
U.S. Senator,MC0524,41,625,420,1086,#f58181
U.S. Senator,MC0525,45,700,1764,2509,#2222aa
U.S. Senator,MC0526,96,1090,1429,2615,#8181f5
U.S. Senator,MC0527,27,1359,812,2198,#eb4747
U.S. Senator,MC0528,34,213,611,858,#2222aa
U.S. Senator,MC0529,39,1564,1122,2725,#f58181
U.S. Senator,MC0530,25,436,822,1283,#3333cc
U.S. Senator,MC0531,33,903,1250,2186,#8181f5
U.S. Senator,MC0532,27,331,496,854,#8181f5
U.S. Senator,MC0533,83,1955,1648,3686,#ffaaae
U.S. Senator,MC0534,24,451,493,968,#d5d9ff
U.S. Senator,MC0535,34,752,701,1487,#ffd5d9
U.S. Senator,MC0536,33,1102,851,1986,#f58181
U.S. Senator,MC0537,19,1069,794,1882,#f58181
U.S. Senator,MC0538,44,899,876,1819,#ffd5d9
U.S. Senator,MC0539,50,399,1535,1984,#111188
U.S. Senator,MC0540,29,2482,972,3483,#aa2222
U.S. Senator,MC0541,52,2511,1153,3716,#cc3333
U.S. Senator,MC0542,54,243,1254,1551,#000066
U.S. Senator,MC0543,67,756,1103,1926,#8181f5
U.S. Senator,MC0544,39,572,517,1128,#ffd5d9
U.S. Senator,MC0545,26,106,599,731,#000066
U.S. Senator,MC0546,37,1417,1583,3037,#aaaeff
U.S. Senator,MC0547,31,338,449,818,#8181f5
U.S. Senator,MC0548,80,395,1726,2201,#000066
U.S. Senator,MC0549,55,512,1250,1817,#2222aa
U.S. Senator,MC0550,85,513,1783,2381,#111188
U.S. Senator,MC0551,104,1330,1497,2931,#aaaeff
U.S. Senator,MC0552,34,493,559,1086,#aaaeff
U.S. Senator,MC0553,54,908,1634,2596,#4747eb
U.S. Senator,MC0554,27,599,1176,1802,#3333cc
U.S. Senator,MC0555,62,963,944,1969,#ffd5d9
U.S. Senator,MC0556,84,779,2036,2899,#2222aa
U.S. Senator,MC0557,68,1650,1047,2765,#eb4747
U.S. Senator,MC0558,67,2402,1604,4073,#f58181
U.S. Senator,MC0559,33,1756,988,2777,#eb4747
U.S. Senator,MC0560,45,560,636,1241,#aaaeff
U.S. Senator,MC0561,11,247,70,328,#881111
U.S. Senator,MC0562,45,664,1043,1752,#4747eb
U.S. Senator,MC0563,35,919,677,1631,#f58181
U.S. Senator,MC0564,3,6,53,62,#000066
U.S. Senator,MC0565,27,483,876,1386,#4747eb
U.S. Senator,MC0566,69,1662,1250,2981,#f58181
U.S. Senator,MC0567,11,223,378,612,#4747eb
U.S. Senator,MC0568,2,86,79,167,#ffd5d9
U.S. Senator,MC0569,24,511,542,1077,#d5d9ff
U.S. Senator,MC0570,16,450,553,1019,#8181f5
U.S. Senator,MC0571,26,759,857,1642,#aaaeff
U.S. Senator,MC0572,26,805,1231,2062,#4747eb
U.S. Senator,MC0573,29,1097,823,1949,#f58181
U.S. Senator,MC0574,36,579,658,1273,#aaaeff
U.S. Senator,MC0575,18,155,615,788,#111188
U.S. Senator,MC0576,33,1043,388,1464,#aa2222
U.S. Senator,MC0577,23,1116,1030,2169,#ffd5d9
U.S. Senator,MC0578,45,839,740,1624,#ffaaae
U.S. Senator,MC0579,54,991,769,1814,#f58181
U.S. Senator,MC0580,39,1447,1670,3156,#aaaeff
U.S. Senator,MC0581,38,1003,1726,2767,#4747eb
U.S. Senator,MC0582,69,346,1422,1837,#111188
U.S. Senator,MC0583,2,20,12,34,#eb4747
U.S. Senator,MC0584,27,1148,1181,2356,#d5d9ff
U.S. Senator,MC0585,84,610,1667,2361,#2222aa
U.S. Senator,MC0586,72,2222,1590,3884,#f58181
U.S. Senator,MC0587,30,959,1038,2027,#d5d9ff
U.S. Senator,MC0588,41,566,539,1146,#ffd5d9
U.S. Senator,MC0589,36,616,1057,1709,#4747eb
U.S. Senator,MC0590,48,1356,980,2384,#f58181
U.S. Senator,MC0591,49,727,946,1722,#8181f5
U.S. Senator,MC0592,22,593,688,1303,#aaaeff
U.S. Senator,MC0593,21,1035,1197,2253,#aaaeff
U.S. Senator,MC0594,21,1485,1069,2575,#f58181
U.S. Senator,MC0595,47,1095,1084,2226,#ffd5d9
U.S. Senator,MC0596,31,1503,1667,3201,#aaaeff
U.S. Senator,MC0597,20,703,565,1288,#f58181
U.S. Senator,MC0598,57,238,1291,1586,#000066
U.S. Senator,MC0599,34,479,477,990,#ffd5d9
U.S. Senator,MC0600,47,1911,1526,3484,#f58181
U.S. Senator,MC0601,86,496,1800,2382,#111188
U.S. Senator,MC0602,53,641,1386,2080,#3333cc
U.S. Senator,MC0603,10,694,392,1096,#eb4747
U.S. Senator,MC0604,42,694,613,1349,#ffaaae
U.S. Senator,MC0605,0,0,2,2,#000066
U.S. Senator,MC0606,0,2,4,6,#3333cc
U.S. Senator,MC0607,0,6,11,17,#4747eb
U.S. Senator,MC0608,59,513,1587,2159,#2222aa
U.S. Senator,MC0609,9,398,626,1033,#4747eb
U.S. Senator,MC0610,69,508,1132,1709,#3333cc
U.S. Senator,MC0611,37,2327,962,3326,#aa2222
U.S. Senator,MC0612,74,3100,1516,4690,#cc3333
U.S. Senator,MC0613,50,142,892,1084,#000066
U.S. Senator,MC0614,1,62,121,184,#3333cc
U.S. Senator,MC0620,59,176,1414,1649,#000066
U.S. Senator,MC0621,24,891,621,1536,#f58181
U.S. Senator,MC0622,16,451,667,1134,#8181f5
U.S. Senator,MC0623,19,164,306,489,#4747eb
U.S. Senator,MC0624,78,1875,1555,3508,#ffaaae
U.S. Senator,MC0625,1,65,25,91,#aa2222
U.S. Senator,MC0626,29,529,404,962,#f58181
U.S. Senator,MC0627,18,374,734,1126,#3333cc
U.S. Senator,MC0628,45,709,642,1396,#ffd5d9
U.S. Senator,MC0629,11,604,407,1022,#f58181
U.S. Senator,MC0630,48,215,756,1019,#111188
U.S. Senator,MC0631,45,314,773,1132,#2222aa
U.S. Senator,MC0632,56,1380,1755,3191,#8181f5
U.S. Senator,MC0633,10,847,633,1490,#f58181
U.S. Senator,MC0634,2,19,14,35,#f58181
U.S. Senator,MC0635,124,545,2251,2920,#111188
U.S. Senator,MC0636,20,626,467,1113,#f58181
U.S. Senator,MC0637,90,1250,1185,2525,#ffd5d9
U.S. Senator,MC0638,64,1150,850,2064,#f58181
U.S. Senator,MC0639,9,164,479,652,#2222aa
U.S. Senator,MC0640,48,1115,1121,2284,#d5d9ff
U.S. Senator,MC0641,48,981,748,1777,#f58181
U.S. Senator,MC0642,86,1654,1160,2900,#f58181
U.S. Senator,MC0643,33,566,569,1168,#d5d9ff
U.S. Senator,MC0644,98,1087,1263,2448,#aaaeff
U.S. Senator,MC0645,46,493,558,1097,#aaaeff
U.S. Senator,MC0646,68,1310,1210,2588,#ffd5d9
U.S. Senator,MC0647,14,915,870,1799,#ffd5d9
U.S. Senator,MC0648,0,3,0,3,#660000
U.S. Senator,MC0649,62,145,960,1167,#000066
U.S. Senator,MC0650,90,2233,1716,4039,#f58181
U.S. Senator,MC0651,45,1324,1980,3349,#8181f5
U.S. Senator,MC0652,12,465,407,884,#ffaaae
U.S. Senator,MC0653,31,305,697,1033,#3333cc
U.S. Senator,MC0654,50,1848,1154,3052,#eb4747
U.S. Senator,MC0655,82,940,1015,2037,#d5d9ff
U.S. Senator,MC0656,36,579,660,1275,#aaaeff
U.S. Senator,MC0657,30,304,575,909,#4747eb
U.S. Senator,MC0658,36,272,646,954,#3333cc
U.S. Senator,MC0659,112,2046,1507,3665,#f58181
U.S. Senator,MC0660,18,673,683,1374,#d5d9ff
U.S. Senator,MC0661,58,809,837,1704,#d5d9ff
U.S. Senator,MC0662,0,23,8,31,#aa2222
U.S. Senator,MC0663,64,963,806,1833,#ffaaae
U.S. Senator,MC0664,46,849,478,1373,#eb4747
U.S. Senator,MC0665,57,2506,2476,5039,#ffd5d9
U.S. Senator,MC0666,20,2197,1288,3505,#eb4747
U.S. Senator,MC0667,13,190,348,551,#4747eb
U.S. Senator,MC0668,22,846,482,1350,#eb4747
U.S. Senator,MC0669,36,1488,862,2386,#eb4747
U.S. Senator,MC0670,40,282,1154,1476,#111188
U.S. Senator,MC0671,34,545,257,836,#cc3333
U.S. Senator,MC0672,65,1621,1160,2846,#f58181
U.S. Senator,MC0673,0,5,4,9,#f58181
U.S. Senator,MC0674,32,1080,734,1846,#f58181
U.S. Senator,MC0675,27,127,384,538,#2222aa
U.S. Senator,MC0676,27,1243,776,2046,#eb4747
U.S. Senator,MC0677,66,2006,1585,3657,#f58181
U.S. Senator,MC0678,27,129,714,870,#000066
U.S. Senator,MC0679,89,3659,2475,6223,#f58181
U.S. Senator,MC0680,32,121,414,567,#111188
U.S. Senator,MC0681,49,602,1437,2088,#3333cc
U.S. Senator,MC0682,46,239,1113,1398,#000066
U.S. Senator,MC0683,23,355,435,813,#aaaeff
U.S. Senator,MC0684,57,464,2155,2676,#000066
U.S. Senator,MC0685,120,3900,2485,6505,#eb4747
U.S. Senator,MC0686,39,385,1205,1629,#111188
U.S. Senator,MC0687,11,91,130,232,#8181f5
U.S. Senator,MC0688,39,1099,761,1899,#f58181
U.S. Senator,MC0689,44,436,717,1197,#4747eb
U.S. Senator,MC0690,89,964,1110,2163,#aaaeff
U.S. Senator,MC0691,17,439,539,995,#8181f5
U.S. Senator,MC0692,43,857,1130,2030,#8181f5
U.S. Senator,MC0693,56,519,986,1561,#4747eb
U.S. Senator,MC0694,47,318,753,1118,#3333cc
U.S. Senator,MC0695,38,466,666,1170,#8181f5
U.S. Senator,MC0696,25,666,700,1391,#d5d9ff
U.S. Senator,MC0697,43,505,1125,1673,#3333cc
U.S. Senator,MC0698,47,624,1195,1866,#3333cc
U.S. Senator,MC0699,58,966,1068,2092,#d5d9ff
U.S. Senator,MC0700,0,214,91,305,#aa2222
U.S. Senator,MC0701,44,2622,1776,4442,#f58181
U.S. Senator,MC0702,80,968,1232,2280,#8181f5
U.S. Senator,MC0703,61,999,787,1847,#f58181
U.S. Senator,MC0704,91,3370,1709,5170,#cc3333
U.S. Senator,MC0705,26,1164,1651,2841,#8181f5
U.S. Senator,MC0706,38,1245,1051,2334,#ffaaae
U.S. Senator,MC0707,78,609,1515,2202,#2222aa
U.S. Senator,MC0708,46,866,1282,2194,#8181f5
U.S. Senator,MC0709,13,467,204,684,#cc3333
U.S. Senator,MC0710,34,177,525,736,#2222aa
U.S. Senator,MC0711,29,488,659,1176,#8181f5
U.S. Senator,MC0712,62,369,1020,1451,#2222aa
U.S. Senator,MC0713,113,1960,1779,3852,#ffd5d9
U.S. Senator,MC0714,72,3244,1942,5258,#eb4747
U.S. Senator,MC0715,35,1286,919,2240,#f58181
U.S. Senator,MC0716,44,1692,1018,2754,#eb4747
U.S. Senator,MC0717,45,740,1375,2160,#4747eb
U.S. Senator,MC0718,68,733,859,1660,#aaaeff
U.S. Senator,MC0719,42,242,946,1230,#111188
U.S. Senator,MC0720,85,352,2057,2494,#000066
U.S. Senator,MC0721,45,932,699,1676,#f58181
U.S. Senator,MC0722,34,2475,2212,4721,#ffaaae
U.S. Senator,MC0723,11,241,128,380,#eb4747
U.S. Senator,MC0724,34,1459,1077,2570,#f58181
U.S. Senator,MC0725,33,125,884,1042,#000066
U.S. Senator,MC0726,6,119,142,267,#aaaeff
U.S. Senator,MC0727,65,1036,1197,2298,#aaaeff
U.S. Senator,MC0728,77,2423,913,3413,#aa2222
U.S. Senator,MC0729,53,599,571,1223,#ffd5d9
U.S. Senator,MC0730,101,2849,2499,5449,#ffaaae
U.S. Senator,MC0731,55,1009,964,2028,#ffd5d9
U.S. Senator,MC0732,37,539,531,1107,#ffd5d9
U.S. Senator,MC0733,21,1107,1434,2562,#8181f5
U.S. Senator,MC0734,55,731,1011,1797,#8181f5
U.S. Senator,MC0735,50,1148,699,1897,#eb4747
U.S. Senator,MC0736,30,692,817,1539,#aaaeff
U.S. Senator,MC0737,57,1300,1032,2389,#f58181
U.S. Senator,MC0738,40,461,2088,2589,#000066
U.S. Senator,MC0739,88,1627,2464,4179,#4747eb
U.S. Senator,MC0740,38,1237,466,1741,#aa2222
U.S. Senator,MC0741,19,1853,882,2754,#cc3333
U.S. Senator,MC0742,55,777,845,1677,#d5d9ff
U.S. Senator,MC0743,73,885,1387,2345,#4747eb
U.S. Senator,MC0744,42,385,1314,1741,#111188
U.S. Senator,MC0745,82,735,822,1639,#aaaeff
U.S. Senator,MC0746,32,648,983,1663,#4747eb
U.S. Senator,MC0747,34,557,847,1438,#4747eb
U.S. Senator,MC0748,56,2151,1127,3334,#cc3333
U.S. Senator,MO0201,2,124,20,146,#660000
U.S. Senator,MO0202,5,102,39,146,#aa2222
U.S. Senator,MO0203,7,304,92,403,#881111
U.S. Senator,MO0204,20,255,81,356,#aa2222
U.S. Senator,MO0205,22,760,44,826,#660000
U.S. Senator,MO0206,1,53,17,71,#881111
U.S. Senator,MO0207,26,925,328,1279,#aa2222
U.S. Senator,MO0208,17,448,162,627,#aa2222
U.S. Senator,MO0209,20,408,194,622,#cc3333
U.S. Senator,MO0210,126,2646,942,3714,#aa2222
U.S. Senator,MO0211,366,7880,3753,11999,#cc3333
U.S. Senator,MO0212,225,5102,2120,7447,#aa2222
U.S. Senator,MO0213,31,932,313,1276,#aa2222
U.S. Senator,MO0214,3,78,14,95,#660000
U.S. Senator,MO0215,129,1948,951,3028,#cc3333
U.S. Senator,MO0216,150,2510,1046,3706,#cc3333
U.S. Senator,MO0217,143,3664,1442,5249,#aa2222
U.S. Senator,MO0218,212,3927,1462,5601,#aa2222
U.S. Senator,MO0219,126,4740,1481,6347,#881111
U.S. Senator,MO0220,344,12247,4069,16660,#aa2222
U.S. Senator,MO0221,16,551,270,837,#cc3333
U.S. Senator,MO0222,22,528,207,757,#aa2222
U.S. Senator,MO0223,3,43,24,70,#eb4747
U.S. Senator,MO0224,11,34,143,188,#111188
U.S. Senator,NA0001,244,742,4300,5286,#000066
U.S. Senator,NA0002,24,154,625,803,#111188
U.S. Senator,NA0003,8,96,81,185,#ffaaae
U.S. Senator,NA0004,163,1143,3069,4375,#2222aa
U.S. Senator,NA0005,44,126,797,967,#000066
U.S. Senator,NA0006,19,42,351,412,#000066
U.S. Senator,NA0007,145,4217,705,5067,#660000
U.S. Senator,NA0008,115,1303,775,2193,#eb4747
U.S. Senator,NA0009,31,688,265,984,#aa2222
U.S. Senator,NA0010,16,593,112,721,#660000
U.S. Senator,NA0011,58,1556,513,2127,#aa2222
U.S. Senator,NA0012,23,558,218,799,#aa2222
U.S. Senator,NA0013,163,4286,1464,5913,#aa2222
U.S. Senator,NA0014,185,3263,3349,6797,#d5d9ff
U.S. Senator,PM0001,30,405,490,925,#aaaeff
U.S. Senator,PM0002,5,59,55,119,#ffd5d9
U.S. Senator,PM0003,9,8,125,142,#000066
U.S. Senator,PM0004,31,64,516,611,#000066
U.S. Senator,PM0005,100,1507,747,2354,#cc3333
U.S. Senator,PM0006,50,1039,736,1825,#f58181
U.S. Senator,PM0007,3,45,33,81,#f58181
U.S. Senator,PM0008,8,156,213,377,#8181f5
U.S. Senator,PM0009,42,776,1125,1943,#8181f5
U.S. Senator,PM0010,32,811,809,1652,#ffd5d9
U.S. Senator,PM0011,51,1468,558,2077,#aa2222
U.S. Senator,PM0012,44,1911,1792,3747,#ffd5d9
U.S. Senator,PM0013,59,927,1051,2037,#aaaeff
U.S. Senator,PM0014,42,1230,1135,2407,#ffd5d9
U.S. Senator,PM0015,23,515,434,972,#ffaaae
U.S. Senator,PM0016,39,778,1717,2534,#3333cc
U.S. Senator,PM0017,28,229,1023,1280,#000066
U.S. Senator,PM0018,42,174,1206,1422,#000066
U.S. Senator,PM0019,8,174,137,319,#f58181
U.S. Senator,PM0020,62,261,1247,1570,#000066
U.S. Senator,PM0021,47,976,1264,2287,#8181f5
U.S. Senator,PM0022,75,501,1308,1884,#2222aa
U.S. Senator,PM0023,60,541,1411,2012,#2222aa
U.S. Senator,PM0024,32,759,605,1396,#f58181
U.S. Senator,PM0025,37,160,1086,1283,#000066
U.S. Senator,PM0026,53,212,1172,1437,#000066
U.S. Senator,PM0027,0,0,0,0,#333333
U.S. Senator,PM0028,31,127,669,827,#000066
U.S. Senator,PM0029,25,1290,1256,2571,#ffd5d9
U.S. Senator,PM0030,27,848,1331,2206,#4747eb
U.S. Senator,PM0031,43,517,591,1151,#aaaeff
U.S. Senator,PM0032,105,1153,1600,2858,#8181f5
U.S. Senator,PM0033,25,479,1022,1526,#3333cc
U.S. Senator,PM0034,33,314,489,836,#4747eb
U.S. Senator,PM0035,7,233,234,474,#d5d9ff
U.S. Senator,PM0036,86,617,1277,1980,#3333cc
U.S. Senator,PM0037,25,133,590,748,#000066
U.S. Senator,PM0038,52,389,863,1304,#3333cc
U.S. Senator,PM0039,46,1395,1116,2557,#f58181
U.S. Senator,PM0040,49,930,811,1790,#ffaaae
U.S. Senator,PM0041,109,973,2007,3089,#3333cc
U.S. Senator,PM0042,61,314,1910,2285,#000066
U.S. Senator,PM0043,33,124,560,717,#000066
U.S. Senator,PM0044,30,190,1180,1400,#000066
U.S. Senator,PM0045,23,107,1108,1238,#000066
U.S. Senator,PM0046,9,497,298,804,#eb4747
U.S. Senator,PM0047,61,198,1178,1437,#000066
U.S. Senator,PM0048,44,308,771,1123,#2222aa
U.S. Senator,PM0049,26,526,401,953,#f58181
U.S. Senator,PM0050,35,161,970,1166,#000066
U.S. Senator,PM0051,36,125,720,881,#000066
U.S. Senator,PM0052,35,159,860,1054,#000066
U.S. Senator,PM0053,100,482,1780,2362,#111188
U.S. Senator,PM0054,121,776,1749,2646,#3333cc
U.S. Senator,PM0055,14,295,614,923,#3333cc
U.S. Senator,PM0056,20,630,1295,1945,#3333cc
U.S. Senator,PM0057,75,512,1620,2207,#111188
U.S. Senator,PM0058,65,360,1437,1862,#111188
U.S. Senator,PM0059,33,241,736,1010,#2222aa
U.S. Senator,PM0060,41,449,414,904,#ffd5d9
U.S. Senator,PM0061,13,698,918,1629,#8181f5
U.S. Senator,PM0062,39,219,1076,1334,#000066
U.S. Senator,PM0063,14,203,905,1122,#000066
U.S. Senator,PM0064,36,135,901,1072,#000066
U.S. Senator,PM0065,0,9,8,17,#ffaaae
U.S. Senator,PM0066,26,198,1016,1240,#000066
U.S. Senator,PM0067,61,408,1172,1641,#2222aa
U.S. Senator,PM0068,36,411,1357,1804,#111188
U.S. Senator,PM0069,63,1315,1735,3113,#8181f5
U.S. Senator,PM0070,46,796,657,1499,#ffaaae
U.S. Senator,PM0071,1,12,85,98,#000066
U.S. Senator,PM0072,91,517,1590,2198,#2222aa
U.S. Senator,PM0073,32,359,1736,2127,#000066
U.S. Senator,PM0074,22,880,806,1708,#ffd5d9
U.S. Senator,PM0075,70,399,1570,2039,#111188
U.S. Senator,PM0076,12,15,178,205,#000066
U.S. Senator,PM0077,13,1085,868,1966,#f58181
U.S. Senator,PM0078,11,213,1130,1354,#000066
U.S. Senator,PM0079,46,1223,983,2252,#f58181
U.S. Senator,PM0080,33,314,1268,1615,#111188
U.S. Senator,PM0081,17,433,369,819,#ffaaae
U.S. Senator,PM0082,44,245,1268,1557,#000066
U.S. Senator,PM0083,20,772,443,1235,#eb4747
U.S. Senator,PM0084,44,2176,1581,3801,#f58181
U.S. Senator,PM0085,24,382,693,1099,#4747eb
U.S. Senator,PM0086,73,533,1723,2329,#111188
U.S. Senator,PM0087,15,117,300,432,#2222aa
U.S. Senator,PM0088,17,912,1242,2171,#8181f5
U.S. Senator,PM0089,38,611,1427,2076,#3333cc
U.S. Senator,PM0090,19,598,459,1076,#f58181
U.S. Senator,PM0091,69,475,1327,1871,#2222aa
U.S. Senator,PM0092,43,967,1350,2360,#8181f5
U.S. Senator,PM0093,24,357,1137,1518,#111188
U.S. Senator,PM0094,37,378,1276,1691,#111188
U.S. Senator,PM0095,23,534,347,904,#eb4747
U.S. Senator,PM0096,41,456,1344,1841,#2222aa
U.S. Senator,PM0097,29,300,950,1279,#111188
U.S. Senator,PM0098,67,456,1191,1714,#2222aa
U.S. Senator,PM0099,24,514,1231,1769,#2222aa
U.S. Senator,PM0100,63,561,1144,1768,#3333cc
U.S. Senator,PM0101,45,550,636,1231,#aaaeff
U.S. Senator,PM0102,38,433,910,1381,#3333cc
U.S. Senator,PM0103,14,249,662,925,#2222aa
U.S. Senator,PM0104,54,1385,1243,2682,#ffaaae
U.S. Senator,PM0105,47,363,583,993,#4747eb
U.S. Senator,PM0106,6,564,591,1161,#d5d9ff
U.S. Senator,PM0107,60,663,1380,2103,#3333cc
U.S. Senator,PM0108,54,875,1861,2790,#3333cc
U.S. Senator,PM0109,61,1857,1290,3208,#f58181
U.S. Senator,PM0110,42,65,700,807,#000066
U.S. Senator,PM0111,47,531,935,1513,#4747eb
U.S. Senator,PM0112,16,1017,1241,2274,#aaaeff
U.S. Senator,PM0113,70,653,990,1713,#8181f5
U.S. Senator,PM0114,6,172,170,348,#ffd5d9
U.S. Senator,PM0115,52,1572,1401,3025,#ffaaae
U.S. Senator,PM0116,80,1122,1416,2618,#8181f5
U.S. Senator,PM0117,38,629,998,1665,#4747eb
U.S. Senator,PM0118,26,870,1295,2191,#8181f5
U.S. Senator,PM0119,33,549,826,1408,#8181f5
U.S. Senator,PM0120,61,741,1136,1938,#4747eb
U.S. Senator,PM0121,23,630,728,1381,#aaaeff
U.S. Senator,PM0122,45,555,698,1298,#8181f5
U.S. Senator,PM0123,92,998,1344,2434,#8181f5
U.S. Senator,PM0124,25,457,523,1005,#aaaeff
U.S. Senator,PM0125,15,706,811,1532,#aaaeff
U.S. Senator,PM0126,7,636,521,1164,#ffaaae
U.S. Senator,PM0127,54,3087,2205,5346,#f58181
U.S. Senator,PM0128,25,750,891,1666,#aaaeff
U.S. Senator,PM0129,40,542,790,1372,#8181f5
U.S. Senator,PM0130,62,1047,1172,2281,#aaaeff
U.S. Senator,PM0131,24,765,771,1560,#d5d9ff
U.S. Senator,PM0132,42,975,1044,2061,#d5d9ff
U.S. Senator,PM0133,66,987,1103,2156,#aaaeff
U.S. Senator,PM0134,30,673,690,1393,#d5d9ff
U.S. Senator,PM0135,6,3,113,122,#000066
U.S. Senator,PM0136,3,7,64,74,#000066
U.S. Senator,PM0137,4,5,74,83,#000066
U.S. Senator,PM0138,13,17,259,289,#000066
U.S. Senator,PM0139,9,99,185,293,#4747eb
U.S. Senator,PM0140,4,259,195,458,#f58181
U.S. Senator,PM0141,60,1691,1719,3470,#d5d9ff
U.S. Senator,PM0142,47,1080,1079,2206,#ffd5d9
U.S. Senator,PM0143,20,54,599,673,#000066
U.S. Senator,PM0144,29,436,1222,1687,#2222aa
U.S. Senator,PM0145,50,2190,1950,4190,#ffaaae
U.S. Senator,PM0146,31,741,974,1746,#8181f5
U.S. Senator,PM0147,48,790,688,1526,#ffaaae
U.S. Senator,PM0148,18,762,858,1638,#aaaeff
U.S. Senator,PM0149,13,623,892,1528,#8181f5
U.S. Senator,PM0150,12,159,216,387,#8181f5
U.S. Senator,PM0151,3,264,437,704,#4747eb
U.S. Senator,PM0152,16,109,402,527,#111188
U.S. Senator,PM0153,54,714,1529,2297,#3333cc
U.S. Senator,PM0154,40,196,622,858,#2222aa
U.S. Senator,PM0155,11,177,472,660,#2222aa
U.S. Senator,PM0156,47,553,657,1257,#aaaeff
U.S. Senator,PM0157,56,317,1127,1500,#111188
U.S. Senator,PM0158,10,582,902,1494,#4747eb
U.S. Senator,PM0159,60,361,1453,1874,#111188
U.S. Senator,PM0160,16,109,630,755,#000066
U.S. Senator,PM0161,7,402,258,667,#eb4747
U.S. Senator,PM0162,17,478,760,1255,#4747eb
U.S. Senator,PM0163,12,736,914,1662,#8181f5
U.S. Senator,PM0164,24,354,1385,1763,#111188
U.S. Senator,PM0165,2,173,75,250,#cc3333
U.S. Senator,PM0166,52,321,1464,1837,#000066
U.S. Senator,PM0167,22,229,997,1248,#000066
U.S. Senator,PM0168,16,382,281,679,#f58181
U.S. Senator,PM0169,44,1598,1283,2925,#f58181
U.S. Senator,PM0170,20,618,1132,1770,#4747eb
U.S. Senator,PM0171,23,1031,1130,2184,#d5d9ff
U.S. Senator,PM0172,36,1463,1132,2631,#f58181
U.S. Senator,PM0173,31,1120,973,2124,#ffaaae
U.S. Senator,PM0174,42,915,1265,2222,#8181f5
U.S. Senator,PM0175,49,944,639,1632,#f58181
U.S. Senator,PM0176,35,692,538,1265,#f58181
U.S. Senator,PM0177,85,1054,1142,2281,#d5d9ff
U.S. Senator,PM0178,29,996,935,1960,#ffd5d9
U.S. Senator,PM0179,29,1578,1261,2868,#f58181
U.S. Senator,PM0180,43,1077,1188,2308,#d5d9ff
U.S. Senator,PM0181,30,1286,1208,2524,#ffd5d9
U.S. Senator,PM0182,62,1159,1214,2435,#d5d9ff
U.S. Senator,PM0183,35,835,821,1691,#ffd5d9
U.S. Senator,PM0184,37,1377,807,2221,#eb4747
U.S. Senator,PM0185,20,610,596,1226,#ffd5d9
U.S. Senator,PM0186,3,122,114,239,#ffd5d9
U.S. Senator,PM0187,36,1309,1232,2577,#ffd5d9
U.S. Senator,PM0188,51,1162,785,1998,#f58181
U.S. Senator,PM0189,21,321,729,1071,#3333cc
U.S. Senator,PM0190,23,196,651,870,#111188
U.S. Senator,PM0191,18,385,380,783,#ffd5d9
U.S. Senator,PM0192,56,1063,1084,2203,#d5d9ff
U.S. Senator,PM0193,10,687,621,1318,#ffaaae
U.S. Senator,PM0194,31,1433,1107,2571,#f58181
U.S. Senator,PM0195,11,877,576,1464,#eb4747
U.S. Senator,PM0196,0,0,5,5,#000066
U.S. Senator,PM0197,44,754,692,1490,#ffd5d9
U.S. Senator,PM0198,19,971,509,1499,#cc3333
U.S. Senator,PM0199,26,1204,892,2122,#f58181
U.S. Senator,PM0200,18,692,413,1123,#eb4747
U.S. Senator,PM0201,37,859,1014,1910,#aaaeff
U.S. Senator,PM0202,34,1232,1138,2404,#ffd5d9
U.S. Senator,PM0203,33,311,543,887,#4747eb
U.S. Senator,PM0204,7,282,56,345,#660000
U.S. Senator,PM0205,35,1308,1000,2343,#f58181
U.S. Senator,PM0206,5,200,128,333,#eb4747
U.S. Senator,PM0207,23,1067,1214,2304,#aaaeff
U.S. Senator,PM0208,40,477,424,941,#ffaaae
U.S. Senator,PM0209,50,1158,963,2171,#ffaaae
U.S. Senator,PM0210,13,610,1227,1850,#3333cc
U.S. Senator,PM0211,17,791,953,1761,#aaaeff
U.S. Senator,PM0212,19,613,543,1175,#ffaaae
U.S. Senator,PM0213,1,114,123,238,#d5d9ff
U.S. Senator,PM0214,28,860,1197,2085,#8181f5
U.S. Senator,PM0215,32,526,388,946,#f58181
U.S. Senator,PM0216,22,925,818,1765,#ffaaae
U.S. Senator,PM0217,76,1358,1180,2614,#ffaaae
U.S. Senator,PM0218,48,1458,1600,3106,#d5d9ff
U.S. Senator,PM0219,44,844,808,1696,#ffd5d9
U.S. Senator,PM0220,23,1315,1165,2503,#ffaaae
U.S. Senator,PM0221,32,1031,453,1516,#cc3333
U.S. Senator,PM0222,53,674,434,1161,#eb4747
U.S. Senator,PM0223,18,434,400,852,#ffd5d9
U.S. Senator,PM0224,65,1368,1181,2614,#ffaaae
U.S. Senator,PM0225,77,1293,1497,2867,#aaaeff
U.S. Senator,PM0226,11,362,364,737,#d5d9ff
U.S. Senator,PM0227,72,1753,1511,3336,#ffaaae
U.S. Senator,PM0228,17,450,526,993,#aaaeff
U.S. Senator,PM0229,74,1780,1009,2863,#eb4747
U.S. Senator,PM0230,14,277,486,777,#4747eb
U.S. Senator,PM0231,70,1178,1177,2425,#ffd5d9
U.S. Senator,PM0232,12,360,518,890,#8181f5
U.S. Senator,PM0233,72,861,1321,2254,#4747eb
U.S. Senator,PM0234,47,480,802,1329,#4747eb
U.S. Senator,PM0235,51,335,947,1333,#2222aa
U.S. Senator,PM0236,17,81,373,471,#000066
U.S. Senator,PM0237,7,479,842,1328,#4747eb
U.S. Senator,PM0238,17,826,1263,2106,#4747eb
U.S. Senator,PM0239,25,1121,1760,2906,#4747eb
U.S. Senator,PM0240,2,71,35,108,#cc3333
U.S. Senator,PM0241,9,719,835,1563,#aaaeff
U.S. Senator,PM0242,32,827,764,1623,#ffd5d9
U.S. Senator,PM0243,14,891,600,1505,#f58181
U.S. Senator,PM0244,20,41,313,374,#000066
U.S. Senator,PM0245,28,132,917,1077,#000066
U.S. Senator,PM0246,28,122,1097,1247,#000066
U.S. Senator,PM0247,10,30,185,225,#000066
U.S. Senator,PM0248,14,62,306,382,#000066
U.S. Senator,PM0249,33,910,570,1513,#eb4747
U.S. Senator,PN0001,29,390,404,823,#d5d9ff
U.S. Senator,PN0004,17,131,212,360,#4747eb
U.S. Senator,PN0005,26,536,562,1124,#d5d9ff
U.S. Senator,PN0006,15,122,377,514,#2222aa
U.S. Senator,PN0007,19,1005,816,1840,#f58181
U.S. Senator,PN0008,25,1361,1011,2397,#f58181
U.S. Senator,PN0009,57,653,449,1159,#f58181
U.S. Senator,PN0010,54,773,464,1291,#eb4747
U.S. Senator,PN0011,5,99,59,163,#eb4747
U.S. Senator,PN0012,10,82,328,420,#111188
U.S. Senator,PN0013,34,844,678,1556,#f58181
U.S. Senator,PN0014,20,84,355,459,#111188
U.S. Senator,PN0015,18,1422,906,2346,#eb4747
U.S. Senator,PN0016,33,799,377,1209,#cc3333
U.S. Senator,PN0017,27,249,287,563,#aaaeff
U.S. Senator,PN0018,50,761,694,1505,#ffd5d9
U.S. Senator,PN0019,37,319,389,745,#aaaeff
U.S. Senator,PN0020,13,255,161,429,#eb4747
U.S. Senator,PN0021,21,357,213,591,#eb4747
U.S. Senator,PN0022,20,280,130,430,#cc3333
U.S. Senator,PN0023,41,550,441,1032,#f58181
U.S. Senator,PN0024,43,401,376,820,#ffd5d9
U.S. Senator,PN0025,24,613,236,873,#aa2222
U.S. Senator,PN0026,39,1156,742,1937,#eb4747
U.S. Senator,PN0027,87,2182,1470,3739,#f58181
U.S. Senator,PN0028,39,1600,994,2633,#eb4747
U.S. Senator,PN0029,20,41,245,306,#000066
U.S. Senator,PN0030,49,759,811,1619,#d5d9ff
U.S. Senator,PN0031,8,128,95,231,#f58181
U.S. Senator,PN0032,41,397,518,956,#8181f5
U.S. Senator,PN0033,30,448,467,945,#d5d9ff
U.S. Senator,PN0034,43,470,545,1058,#aaaeff
U.S. Senator,PN0035,35,570,548,1153,#ffd5d9
U.S. Senator,PN0036,20,271,501,792,#4747eb
U.S. Senator,PN0037,54,891,756,1701,#ffaaae
U.S. Senator,PN0038,19,339,293,651,#ffaaae
U.S. Senator,PN0039,33,839,621,1493,#f58181
U.S. Senator,PN0040,49,755,704,1508,#ffd5d9
U.S. Senator,PN0041,30,899,615,1544,#f58181
U.S. Senator,PN0042,35,442,358,835,#f58181
U.S. Senator,PN0043,49,796,607,1452,#f58181
U.S. Senator,PN0044,53,878,575,1506,#eb4747
U.S. Senator,PN0045,32,855,439,1326,#cc3333
U.S. Senator,PN0046,33,806,461,1300,#eb4747
U.S. Senator,PN0047,39,582,490,1111,#ffaaae
U.S. Senator,PN0048,21,880,606,1507,#f58181
U.S. Senator,PN0049,7,264,115,386,#cc3333
U.S. Senator,PN0050,32,227,621,880,#2222aa
U.S. Senator,PN0051,1,19,7,27,#aa2222
U.S. Senator,PN0052,1,59,26,86,#cc3333
U.S. Senator,PN0053,2,8,98,108,#000066
U.S. Senator,PN0054,25,600,326,951,#eb4747
U.S. Senator,PN0055,32,626,550,1208,#ffaaae
U.S. Senator,PN0056,38,653,432,1123,#f58181
U.S. Senator,PN0057,29,1022,591,1642,#eb4747
U.S. Senator,PN0058,42,622,347,1011,#eb4747
U.S. Senator,PN0059,72,905,613,1590,#f58181
U.S. Senator,PN0060,11,35,219,265,#000066
U.S. Senator,PN0061,14,43,175,232,#111188
U.S. Senator,PN0062,15,30,229,274,#000066
U.S. Senator,PN0063,27,422,304,753,#f58181
U.S. Senator,PN0064,27,1236,725,1988,#eb4747
U.S. Senator,PN0066,10,801,471,1282,#eb4747
U.S. Senator,PN0067,23,427,269,719,#eb4747
U.S. Senator,PN0068,47,832,651,1530,#f58181
U.S. Senator,PN0069,29,480,375,884,#f58181
U.S. Senator,PN0070,49,750,499,1298,#f58181
U.S. Senator,PN0071,39,792,419,1250,#eb4747
U.S. Senator,PN0072,10,427,269,706,#eb4747
U.S. Senator,PN0073,29,450,437,916,#ffd5d9
U.S. Senator,PN0074,37,654,730,1421,#aaaeff
U.S. Senator,PN0075,49,843,608,1500,#f58181
U.S. Senator,PN0076,34,842,473,1349,#eb4747
U.S. Senator,PN0077,15,28,145,188,#000066
U.S. Senator,PN0078,43,726,658,1427,#ffd5d9
U.S. Senator,PN0079,32,801,798,1631,#ffd5d9
U.S. Senator,PN0080,63,1692,1508,3263,#ffaaae
U.S. Senator,PN0081,46,815,705,1566,#ffaaae
U.S. Senator,PN0082,20,126,232,378,#4747eb
U.S. Senator,PN0083,45,980,769,1794,#f58181
U.S. Senator,PN0084,10,482,311,803,#eb4747
U.S. Senator,PN0085,27,796,555,1378,#f58181
U.S. Senator,PN0086,56,1096,863,2015,#f58181
U.S. Senator,PN0087,44,599,541,1184,#ffd5d9
U.S. Senator,PN0088,74,2319,1161,3554,#cc3333
U.S. Senator,PN0089,44,1033,583,1660,#eb4747
U.S. Senator,PN0090,26,540,616,1182,#aaaeff
U.S. Senator,PN0091,43,521,287,851,#eb4747
U.S. Senator,PN0092,28,1646,1251,2925,#f58181
U.S. Senator,PN0093,17,417,504,938,#aaaeff
U.S. Senator,PN0094,33,738,544,1315,#f58181
U.S. Senator,PN0095,20,672,455,1147,#f58181
U.S. Senator,PN0096,25,670,335,1030,#cc3333
U.S. Senator,PN0097,34,667,523,1224,#f58181
U.S. Senator,PN0098,22,599,406,1027,#f58181
U.S. Senator,PN0099,41,726,606,1373,#ffaaae
U.S. Senator,PN0100,39,529,594,1162,#aaaeff
U.S. Senator,PN0101,46,536,658,1240,#aaaeff
U.S. Senator,PN0102,59,787,741,1587,#ffd5d9
U.S. Senator,PN0103,0,0,0,0,#333333
U.S. Senator,PN0104,3,77,52,132,#f58181
U.S. Senator,PN0105,1,25,29,55,#aaaeff
U.S. Senator,SC0001,15,38,201,254,#000066
U.S. Senator,SC0002,20,108,444,572,#111188
U.S. Senator,SC0003,14,50,302,366,#000066
U.S. Senator,SC0004,8,35,148,191,#111188
U.S. Senator,SC0005,18,119,454,591,#111188
U.S. Senator,SC0006,11,301,172,484,#eb4747
U.S. Senator,SC0007,48,655,1074,1777,#4747eb
U.S. Senator,SC0008,44,139,794,977,#000066
U.S. Senator,SC0009,6,54,118,178,#3333cc
U.S. Senator,SC0010,15,82,316,413,#111188
U.S. Senator,SC0011,23,498,755,1276,#4747eb
U.S. Senator,SC0012,7,41,230,278,#000066
U.S. Senator,SC0013,4,71,144,219,#3333cc
U.S. Senator,SC0014,14,196,413,623,#3333cc
U.S. Senator,SC0015,9,418,261,688,#eb4747
U.S. Senator,SC0016,9,46,135,190,#2222aa
U.S. Senator,SC0017,51,300,1006,1357,#111188
U.S. Senator,SC0018,4,81,263,348,#111188
U.S. Senator,SC0019,32,228,734,994,#111188
U.S. Senator,SC0020,20,73,410,503,#000066
U.S. Senator,SC0021,33,199,621,853,#2222aa
U.S. Senator,SC0022,5,33,172,210,#000066
U.S. Senator,SC0023,1,20,19,40,#ffd5d9
U.S. Senator,SCNA,7,43,55,105,#8181f5
U.S. Senator,YA0201,140,3914,2554,6608,#eb4747
U.S. Senator,YA0202,133,2342,2172,4647,#ffd5d9
U.S. Senator,YA0203,104,1894,1561,3559,#ffaaae
U.S. Senator,YA0204,114,2866,2372,5352,#ffaaae
U.S. Senator,YA0205,9,348,109,466,#881111
U.S. Senator,YA0206,2,50,5,57,#660000
U.S. Senator,YA0207,21,753,253,1027,#aa2222
U.S. Senator,YA0208,9,371,201,581,#eb4747
U.S. Senator,YA0209,6,365,122,493,#aa2222
U.S. Senator,YA0210,0,33,19,52,#eb4747
U.S. Senator,YA0211,0,22,7,29,#881111
U.S. Senator,YA0212,0,0,0,0,#333333
U.S. Senator,YA0213,9,213,80,302,#aa2222
U.S. Senator,YA0214,12,318,133,463,#cc3333
U.S. Senator,YA0215,74,2327,1066,3467,#cc3333
U.S. Senator,YA0216,49,988,837,1874,#ffaaae
U.S. Senator,YA0217,1,49,35,85,#f58181
U.S. Senator,YA0218,66,1133,779,1978,#f58181
U.S. Senator,YA0219,136,2797,1378,4311,#cc3333
U.S. Senator,YA0220,0,14,10,24,#f58181
U.S. Senator,YA0221,5,194,89,288,#cc3333
U.S. Senator,YA0222,90,1435,700,2225,#cc3333
U.S. Senator,YA0223,33,851,325,1209,#aa2222
U.S. Senator,YA0224,2,62,16,80,#881111
U.S. Senator,YA0225,149,3198,1313,4660,#aa2222
U.S. Senator,YA0226,3,23,19,45,#ffaaae
U.S. Senator,YA0227,112,1604,2878,4594,#4747eb
U.S. Senator,YA0228,71,1669,2370,4110,#8181f5
U.S. Senator,YA0229,190,2921,2410,5521,#ffaaae
U.S. Senator,YA0230,162,2430,2196,4788,#ffd5d9
U.S. Senator,YA0231,4,208,85,297,#aa2222
U.S. Senator,YA0232,66,771,1060,1897,#8181f5
U.S. Senator,YA0233,2,19,29,50,#8181f5
U.S. Senator,YA0234,133,4331,2412,6876,#eb4747
U.S. Senator,YA0235,43,2614,932,3589,#aa2222
U.S. Senator,YA0236,10,330,118,458,#aa2222
U.S. Senator,YA0237,130,3173,1030,4333,#aa2222
U.S. Senator,YA0238,146,3813,1274,5233,#aa2222
U.S. Senator,YA0239,43,1602,375,2020,#660000
U.S. Senator,YA0240,17,406,151,574,#aa2222
U.S. Senator,YA0241,14,286,112,412,#aa2222
U.S. Senator,YA0242,74,2745,1452,4271,#cc3333
U.S. Senator,YA0243,153,3682,1789,5624,#cc3333
U.S. Senator,YA0244,200,4056,2163,6419,#eb4747
U.S. Senator,YA0245,133,2088,1169,3390,#eb4747
U.S. Senator,YU0001,15,144,302,461,#3333cc
U.S. Senator,YU0002,25,209,332,566,#4747eb
U.S. Senator,YU0003,22,219,290,531,#8181f5
U.S. Senator,YU0004,62,687,967,1716,#8181f5
U.S. Senator,YU0005,25,760,422,1207,#eb4747
U.S. Senator,YU0006,47,288,679,1014,#3333cc
U.S. Senator,YU0007,44,205,1063,1312,#000066
U.S. Senator,YU0008,19,506,241,766,#cc3333
U.S. Senator,YU0009,13,894,257,1164,#881111
U.S. Senator,YU0010,55,1415,731,2201,#cc3333
U.S. Senator,YU0011,30,753,441,1224,#eb4747
U.S. Senator,YU0012,30,881,337,1248,#aa2222
U.S. Senator,YU0013,25,330,400,755,#aaaeff
U.S. Senator,YU0014,18,148,113,279,#f58181
U.S. Senator,YU0015,50,759,540,1349,#f58181
U.S. Senator,YU0016,41,496,434,971,#ffaaae
U.S. Senator,YU0017,54,1192,568,1814,#cc3333
U.S. Senator,YU0018,1,106,22,129,#660000
U.S. Senator,YU0019,5,43,32,80,#f58181
U.S. Senator,YU0020,29,904,398,1331,#cc3333
U.S. Senator,YU0021,0,15,4,19,#881111
U.S. Senator,YU0022,45,914,476,1435,#cc3333
U.S. Senator,YU0023,30,920,410,1360,#cc3333
U.S. Senator,YU0024,99,2437,888,3424,#aa2222
U.S. Senator,YU0025,25,1397,502,1924,#aa2222
U.S. Senator,YU0026,13,95,170,278,#4747eb
U.S. Senator,YU0027,14,249,211,474,#ffaaae
U.S. Senator,YU0028,9,106,191,306,#4747eb
U.S. Senator,YU0029,47,122,1146,1315,#000066
U.S. Senator,YU0030,51,113,1082,1246,#000066
U.S. Senator,YU0031,71,194,1371,1636,#000066
U.S. Senator,YU0032,29,195,356,580,#4747eb
U.S. Senator,YU0033,8,197,135,340,#f58181
U.S. Senator,YU0034,7,315,102,424,#881111
U.S. Senator,YU0035,20,541,414,975,#f58181
U.S. Senator,YU0036,41,572,557,1170,#ffd5d9
U.S. Senator,YU0037,36,321,532,889,#4747eb
U.S. Senator,YU0038,37,470,517,1024,#d5d9ff
U.S. Senator,YU0039,28,582,472,1082,#f58181
U.S. Senator,YU0040,42,559,516,1117,#ffd5d9
U.S. Senator,YU0041,28,687,552,1267,#f58181
U.S. Senator,YU0042,60,580,697,1337,#aaaeff
U.S. Senator,YU0043,1,12,10,23,#ffaaae
U.S. Senator,YU0044,0,0,0,0,#333333
